Time,Type,Order,Size,Price,SL,TP,Profit,Balance
1987.01.02 21:00,s/l,1,0.50,1.05072,1.05072,1.06067,-199.00,9801.00
1987.01.09 03:00,s/l,2,0.46,1.05166,1.05166,1.06225,-195.41,9605.59
1987.01.20 12:00,s/l,3,0.30,1.10534,1.10534,1.08925,-112.20,9493.39
1987.01.23 07:00,s/l,4,0.27,1.10089,1.10089,1.11791,-308.29,9185.11
1987.01.30 14:00,t/p,5,0.29,1.10797,1.12368,1.10797,302.47,9487.58
1987.01.30 16:00,s/l,7,0.27,1.10661,1.10661,1.08909,-73.17,9414.41
1987.02.02 09:00,s/l,6,0.12,1.11459,1.11459,1.09023,-128.51,9285.90
1987.02.06 06:00,t/p,8,0.26,1.09204,1.10981,1.09204,362.47,9648.36
1987.02.06 11:00,s/l,9,0.26,1.09150,1.09150,1.07274,-78.00,9570.36
1987.02.18 22:00,s/l,10,0.27,1.10186,1.10186,1.11921,-187.81,9382.55
1987.03.03 15:00,s/l,11,0.42,1.10311,1.10311,1.09208,-186.02,9196.53
1987.03.05 17:00,s/l,12,0.44,1.10267,1.10267,1.09224,-185.99,9010.55
1987.03.06 14:00,s/l,13,0.49,1.09925,1.09925,1.10838,-233.14,8777.40
1987.03.11 19:00,s/l,14,0.48,1.08444,1.08444,1.07509,-78.72,8698.68
1987.03.30 06:00,s/l,15,0.53,1.12374,1.12374,1.13190,-178.08,8520.60
1987.03.30 07:00,s/l,16,0.40,1.12138,1.12138,1.13320,-168.80,8351.80
1987.04.03 13:00,s/l,17,0.40,1.11041,1.11041,1.12063,-151.92,8199.88
1987.04.03 17:00,s/l,18,0.36,1.10953,1.10953,1.12232,-164.81,8035.08
1987.04.06 17:00,t/p,19,0.38,1.10328,1.11382,1.10328,163.44,8198.51
1987.04.08 21:00,s/l,20,0.39,1.10540,1.10540,1.09491,-163.80,8034.71
1987.04.13 03:00,close,21,0.32,1.12160,1.11065,1.12451,191.74,8226.46
1987.04.23 17:00,s/l,22,0.42,1.11527,1.11527,1.10559,-165.73,8060.73
1987.04.24 14:00,t/p,23,0.33,1.12776,1.11538,1.12776,302.02,8362.74
1987.05.15 14:00,close,24,0.32,1.13530,1.12873,1.14321,44.54,8407.29
1987.05.26 02:00,t/p,25,0.56,1.12949,1.13700,1.12949,211.23,8618.52
1987.05.26 11:00,t/p,26,0.60,1.12573,1.13285,1.12573,256.20,8874.72
1987.05.27 11:00,t/p,27,0.39,1.10780,1.12025,1.10780,312.00,9186.72
1987.06.01 14:00,s/l,28,0.49,1.10214,1.10214,1.09278,-60.76,9125.96
1987.06.02 16:00,t/p,29,0.46,1.11964,1.10991,1.11964,268.64,9394.60
1987.06.03 06:00,s/l,30,0.37,1.12187,1.12187,1.13595,-186.11,9208.49
1987.06.04 10:00,s/l,31,0.33,1.11365,1.11365,1.09839,-179.85,9028.64
1987.06.15 09:00,t/p,32,0.35,1.11069,1.12354,1.11069,286.69,9315.32
1987.06.23 20:00,s/l,33,0.46,1.10003,1.10003,1.11020,-104.42,9210.90
1987.07.15 13:00,s/l,34,0.60,1.09433,1.09433,1.08584,-182.94,9027.96
1987.07.16 04:00,s/l,35,0.63,1.10126,1.10126,1.10837,-123.73,8904.23
1987.07.16 14:00,s/l,36,0.54,1.09988,1.09988,1.10918,-179.28,8724.95
1987.08.03 17:00,t/p,37,0.73,1.08342,1.08938,1.08342,259.95,8984.90
1987.08.04 13:00,t/p,38,0.73,1.07505,1.08114,1.07505,265.06,9249.97
1987.08.04 15:00,t/p,39,0.45,1.07059,1.08180,1.07059,323.59,9573.56
1987.08.04 18:00,s/l,40,0.69,1.07125,1.07125,1.06438,-189.75,9383.81
1987.08.11 17:00,t/p,41,0.67,1.06415,1.07124,1.06415,369.30,9753.12
1987.08.14 01:00,s/l,42,0.63,1.06844,1.06844,1.07608,-231.08,9522.03
1987.08.14 17:00,s/l,43,0.55,1.07607,1.07607,1.08465,-188.65,9333.38
1987.08.19 08:00,s/l,44,0.45,1.09571,1.09571,1.10773,-17.91,9315.47
1987.09.03 03:00,s/l,45,0.52,1.12270,1.12270,1.13169,-152.05,9163.42
1987.09.11 13:00,s/l,46,0.56,1.12357,1.12357,1.11514,-30.58,9132.85
1987.09.11 16:00,s/l,47,0.58,1.12400,1.12400,1.13175,-133.40,8999.45
1987.09.16 19:00,s/l,48,0.55,1.11432,1.11432,1.10626,-177.10,8822.35
1987.09.21 15:00,s/l,49,0.46,1.11390,1.11390,1.12455,-174.80,8647.55
1987.09.29 16:00,s/l,50,0.63,1.10052,1.10052,1.09371,-171.36,8476.19
1987.09.29 16:00,s/l,51,0.45,1.10075,1.10075,1.09025,-65.25,8410.94
1987.10.05 12:00,s/l,52,0.66,1.09623,1.09623,1.08991,-199.98,8210.96
1987.10.08 21:00,s/l,53,0.58,1.11250,1.11250,1.11949,-162.40,8048.56
1987.10.13 08:00,s/l,54,0.60,1.11043,1.11043,1.10361,-37.80,8010.76
1987.10.15 03:00,t/p,55,0.57,1.12055,1.11347,1.12055,286.48,8297.24
1987.10.15 18:00,s/l,56,0.46,1.11822,1.11822,1.12824,-164.68,8132.56
1987.10.19 05:00,s/l,57,0.48,1.13686,1.13686,1.14520,-126.72,8005.84
1987.10.22 14:00,s/l,58,0.36,1.11745,1.11745,1.10528,-156.60,7849.24
1987.10.26 11:00,t/p,59,0.33,1.14036,1.12843,1.14036,298.72,8147.96
1987.10.27 00:00,close,60,0.30,1.13840,1.13392,1.14898,-27.24,8120.72
1987.10.28 18:00,t/p,61,0.30,1.15680,1.14330,1.15680,320.76,8441.48
1987.10.28 21:00,s/l,62,0.29,1.16011,1.16011,1.17458,-167.91,8273.57
1987.11.03 02:00,close,64,0.24,1.18070,1.17483,1.19407,-24.19,8249.37
1987.11.03 12:00,t/p,63,0.28,1.18574,1.17118,1.18574,244.50,8493.87
1987.11.10 19:00,s/l,65,0.26,1.21161,1.21161,1.19558,-166.66,8327.21
1987.11.17 08:00,s/l,66,0.28,1.19043,1.19043,1.17535,-146.97,8180.24
1987.11.24 21:00,s/l,67,0.21,1.21027,1.21027,1.18851,-163.17,8017.07
1987.11.30 00:00,t/p,68,0.32,1.22906,1.21596,1.22906,465.66,8482.73
1987.12.01 09:00,s/l,69,0.23,1.22489,1.22489,1.24508,-166.01,8316.72
1987.12.01 15:00,s/l,70,0.30,1.22560,1.22560,1.21186,-165.00,8151.72
1987.12.11 00:00,t/p,71,0.27,1.24047,1.22536,1.24047,201.47,8353.19
1987.12.14 12:00,close,72,0.25,1.24430,1.23154,1.25018,152.30,8505.49
1987.12.28 08:00,s/l,73,0.38,1.26177,1.26177,1.27285,-168.34,8337.15
1987.12.31 03:00,t/p,74,0.28,1.27707,1.26078,1.27707,437.64,8774.79
1987.12.31 08:00,s/l,75,0.39,1.27335,1.27335,1.28473,-48.75,8726.04
1987.12.31 16:00,t/p,76,0.30,1.28647,1.27003,1.28647,317.10,9043.14
1988.01.05 08:00,t/p,77,0.29,1.26209,1.27937,1.26209,322.19,9365.33
1988.01.05 15:00,t/p,78,0.27,1.24257,1.26175,1.24257,332.91,9698.24
1988.01.06 12:00,close,79,0.25,1.22950,1.24707,1.22587,250.00,9948.24
1988.01.06 14:00,s/l,80,0.25,1.22342,1.22342,1.20363,-198.00,9750.24
1988.01.18 01:00,t/p,81,0.23,1.19014,1.21074,1.19014,283.84,10034.08
1988.01.22 08:00,s/l,82,0.20,1.21049,1.21049,1.23740,-72.84,9961.24
1988.01.25 04:00,close,83,0.21,1.20780,1.21827,1.19287,29.00,9990.25
1988.01.29 20:00,t/p,84,0.46,1.20103,1.21181,1.20103,306.82,10297.07
1988.02.01 08:00,t/p,85,0.30,1.19346,1.21172,1.19346,351.63,10648.70
1988.02.02 17:00,s/l,86,0.32,1.20117,1.20117,1.18277,-210.85,10437.85
1988.02.08 16:00,s/l,87,0.39,1.19162,1.19162,1.17673,-176.28,10261.57
1988.02.12 14:00,t/p,88,0.55,1.18487,1.19409,1.18487,304.15,10565.72
1988.02.15 10:00,s/l,90,0.44,1.18368,1.18368,1.17029,-210.32,10355.40
1988.02.16 18:00,s/l,89,0.50,1.18508,1.18508,1.17462,-235.90,10119.50
1988.03.04 17:00,s/l,91,0.69,1.19551,1.19551,1.18824,-185.33,9934.16
1988.03.04 17:00,s/l,92,0.50,1.19442,1.19442,1.18344,-124.80,9809.36
1988.03.07 10:00,s/l,93,0.75,1.19360,1.19360,1.20010,-218.10,9591.26
1988.03.08 16:00,t/p,94,0.52,1.21302,1.20288,1.21302,339.04,9930.30
1988.03.18 17:00,t/p,95,0.60,1.19112,1.19975,1.19112,471.66,10401.96
1988.03.24 20:00,t/p,96,0.52,1.20570,1.19465,1.20570,369.20,10771.16
1988.03.25 03:00,s/l,97,0.51,1.20106,1.20106,1.21266,-211.55,10559.62
1988.03.28 16:00,t/p,98,0.65,1.21654,1.20847,1.21654,314.60,10874.22
1988.04.06 17:00,t/p,99,0.48,1.20318,1.21565,1.20318,384.05,11258.26
1988.04.07 01:00,s/l,100,0.55,1.20580,1.20580,1.19554,-157.13,11101.13
1988.04.18 16:00,close,102,0.44,1.21920,1.20826,1.22238,259.25,11360.38
1988.04.21 08:00,s/l,101,0.57,1.21009,1.21009,1.22011,-83.56,11276.81
1988.05.02 06:00,t/p,103,0.95,1.20162,1.20758,1.20162,423.80,11700.61
1988.05.06 08:00,s/l,104,0.97,1.20252,1.20252,1.19648,-314.18,11386.43
1988.05.18 22:00,s/l,105,0.90,1.18912,1.18912,1.18282,-219.51,11166.92
1988.05.27 17:00,t/p,106,0.87,1.17588,1.18224,1.17588,262.74,11429.66
1988.05.30 12:00,t/p,107,0.76,1.16830,1.17670,1.16830,410.40,11840.06
1988.05.31 03:00,s/l,108,0.75,1.17345,1.17345,1.16464,-237.68,11602.38
1988.06.01 05:00,s/l,109,0.95,1.16862,1.16862,1.16257,-260.20,11342.18
1988.06.03 16:00,s/l,110,0.81,1.16992,1.16992,1.17688,-225.83,11116.35
1988.06.09 01:00,s/l,111,0.63,1.17439,1.17439,1.16461,-223.46,10892.89
1988.06.10 14:00,s/l,112,0.58,1.17499,1.17499,1.18538,-215.18,10677.71
1988.06.13 20:00,close,113,0.55,1.17270,1.17597,1.16513,-33.00,10644.71
1988.06.15 13:00,t/p,114,0.61,1.15336,1.16259,1.15336,605.18,11249.89
1988.06.15 23:00,close,115,0.50,1.15300,1.16095,1.14878,180.00,11429.89
1988.06.21 10:00,s/l,116,0.66,1.15084,1.15084,1.14225,-228.29,11201.60
1988.06.23 12:00,t/p,117,0.52,1.12705,1.13911,1.12705,403.00,11604.60
1988.06.27 06:00,t/p,118,0.46,1.10538,1.11926,1.10538,409.45,12014.04
1988.06.28 15:00,s/l,119,0.54,1.12011,1.12011,1.13108,-139.86,11874.18
1988.06.28 15:00,s/l,120,0.44,1.11841,1.11841,1.13351,-237.16,11637.02
1988.07.05 03:00,s/l,121,0.46,1.10930,1.10930,1.09680,-226.27,11410.75
1988.07.14 18:00,t/p,122,0.53,1.09270,1.10354,1.09270,444.46,11855.21
1988.07.18 09:00,t/p,123,0.62,1.07124,1.08100,1.07124,430.34,12285.55
1988.07.20 00:00,t/p,124,0.48,1.09376,1.07951,1.09376,439.30,12724.84
1988.07.21 15:00,s/l,125,0.55,1.09689,1.09689,1.10842,-231.55,12493.29
1988.07.27 13:00,s/l,126,0.49,1.08334,1.08334,1.07048,-129.36,12363.93
1988.08.01 02:00,t/p,127,0.38,1.07321,1.09108,1.07321,435.18,12799.11
1988.08.09 15:00,close,128,0.42,1.05570,1.06857,1.05186,322.60,13121.71
1988.08.10 17:00,s/l,129,0.58,1.05935,1.05935,1.04797,-224.40,12897.31
1988.08.10 17:00,s/l,130,0.45,1.05902,1.05902,1.04273,-261.90,12635.41
1988.08.11 09:00,t/p,131,0.61,1.06555,1.05513,1.06555,416.39,13051.80
1988.08.16 17:00,s/l,132,0.61,1.07824,1.07824,1.08888,-418.46,12633.34
1988.08.17 17:00,t/p,133,0.45,1.05502,1.07070,1.05502,453.60,13086.94
1988.08.22 18:00,s/l,135,0.45,1.06054,1.06054,1.04418,-262.80,12824.14
1988.08.23 13:00,s/l,134,0.49,1.06324,1.06324,1.05014,-233.19,12590.94
1988.09.02 13:00,s/l,136,0.39,1.08231,1.08231,1.06436,-252.95,12337.99
1988.09.06 11:00,close,138,0.41,1.09180,1.08306,1.09997,110.37,12448.36
1988.09.06 12:00,t/p,137,0.56,1.09409,1.08310,1.09409,368.14,12816.51
1988.09.08 07:00,s/l,139,0.62,1.09162,1.09162,1.10207,-99.94,12716.56
1988.09.08 17:00,s/l,140,0.45,1.09092,1.09092,1.10711,-261.54,12455.02
1988.09.14 13:00,t/p,141,0.82,1.08695,1.09453,1.08695,371.54,12826.56
1988.09.16 04:00,s/l,142,0.77,1.08072,1.08072,1.07216,-61.29,12765.27
1988.09.16 06:00,s/l,143,0.57,1.08157,1.08157,1.06877,-264.82,12500.45
1988.09.22 16:00,t/p,144,0.91,1.07388,1.08074,1.07388,424.33,12924.78
1988.09.29 02:00,s/l,145,0.98,1.07399,1.07399,1.08052,-249.12,12675.67
1988.09.30 16:00,t/p,146,1.26,1.07860,1.07360,1.07860,378.00,13053.67
1988.10.03 16:00,t/p,147,1.21,1.08567,1.08022,1.08567,721.40,13775.07
1988.10.04 13:00,close,148,0.85,1.08770,1.08138,1.09039,475.32,14250.39
1988.10.13 15:00,s/l,149,0.92,1.11123,1.11123,1.11890,-282.44,13967.95
1988.10.14 19:00,s/l,150,0.85,1.11734,1.11734,1.12548,-277.10,13690.85
1988.10.28 11:00,s/l,151,0.65,1.13322,1.13322,1.14391,-124.28,13566.57
1988.11.04 14:00,t/p,152,0.64,1.12922,1.13986,1.12922,394.30,13960.87
1988.11.07 12:00,s/l,153,0.66,1.13117,1.13117,1.12050,-243.47,13717.40
1988.11.08 11:00,s/l,154,0.52,1.13242,1.13242,1.14692,-269.36,13448.04
1988.11.11 08:00,t/p,155,0.45,1.15808,1.14147,1.15808,480.24,13928.28
1988.11.11 10:00,t/p,156,0.51,1.16165,1.14824,1.16165,410.14,14338.42
1988.11.17 15:00,s/l,157,0.56,1.16787,1.16787,1.18144,293.78,14632.20
1988.11.17 15:00,s/l,158,0.46,1.16983,1.16983,1.18795,-297.62,14334.58
1988.11.24 05:00,close,160,0.44,1.17720,1.16938,1.18763,56.14,14390.72
1988.11.28 02:00,s/l,159,0.48,1.16915,1.16915,1.18353,-72.29,14318.43
1988.11.29 14:00,s/l,162,0.46,1.16934,1.16934,1.15186,-268.64,14049.79
1988.12.02 14:00,t/p,161,0.61,1.16027,1.17182,1.16027,415.78,14465.57
1988.12.06 15:00,s/l,163,0.85,1.16951,1.16951,1.17798,-288.83,14176.74
1988.12.07 05:00,t/p,164,0.85,1.15750,1.16616,1.15750,754.88,14931.62
1988.12.07 17:00,t/p,165,0.59,1.14829,1.16230,1.14829,531.59,15463.21
1988.12.14 14:00,s/l,166,0.73,1.15822,1.15822,1.14766,-309.45,15153.77
1988.12.14 14:00,s/l,167,0.60,1.16041,1.16041,1.14611,-307.74,14846.03
1988.12.15 14:00,s/l,168,0.69,1.15983,1.15983,1.17075,-282.49,14563.54
1988.12.16 01:00,s/l,169,0.62,1.15437,1.15437,1.14220,19.28,14582.82
1988.12.16 09:00,s/l,170,0.52,1.15655,1.15655,1.14184,-310.39,14272.43
1988.12.29 05:00,close,171,0.59,1.12610,1.13456,1.12040,504.04,14776.47
1989.01.03 06:00,t/p,172,0.86,1.14572,1.13668,1.14572,911.94,15688.42
1989.01.03 17:00,s/l,173,0.93,1.14564,1.14564,1.15403,-405.48,15282.94
1989.01.05 16:00,close,174,0.60,1.12500,1.13736,1.12319,434.58,15717.52
1989.01.06 13:00,t/p,175,0.85,1.11929,1.12848,1.11929,466.74,16184.25
1989.01.09 09:00,t/p,176,0.77,1.10775,1.11816,1.10775,510.59,16694.84
1989.01.10 00:00,s/l,177,0.64,1.11240,1.11240,1.09783,-334.02,16360.82
1989.01.17 01:00,close,178,0.56,1.09040,1.09580,1.07955,-23.46,16337.36
1989.01.18 14:00,s/l,179,0.71,1.09146,1.09146,1.08006,-323.76,16013.60
1989.01.20 15:00,t/p,180,0.66,1.09757,1.08528,1.09757,690.49,16704.09
1989.02.01 11:00,s/l,181,0.71,1.08049,1.08049,1.06876,-334.34,16369.75
1989.02.01 12:00,s/l,182,0.59,1.08139,1.08139,1.06686,-266.03,16103.72
1989.02.14 00:00,s/l,183,0.59,1.08539,1.08539,1.07030,-319.13,15784.59
1989.02.15 15:00,t/p,184,0.72,1.10205,1.09096,1.10205,679.82,16464.41
1989.02.21 03:00,s/l,185,0.60,1.09211,1.09211,1.10693,-302.28,16162.13
1989.02.21 17:00,s/l,186,0.61,1.09812,1.09812,1.08350,-318.42,15843.71
1989.02.24 10:00,s/l,187,0.59,1.10394,1.10394,1.11895,-316.71,15527.00
1989.03.02 00:00,close,188,0.57,1.10110,1.10551,1.09037,-60.25,15466.75
1989.03.08 18:00,close,189,0.68,1.08600,1.09535,1.08262,325.11,15791.86
1989.03.09 16:00,s/l,190,0.86,1.08700,1.08700,1.07776,-108.10,15683.76
1989.03.15 10:00,s/l,191,0.94,1.08439,1.08439,1.09267,-246.09,15437.67
1989.03.20 09:00,s/l,192,1.01,1.07905,1.07905,1.07142,-107.97,15329.70
1989.03.23 17:00,s/l,193,0.86,1.08087,1.08087,1.09075,-303.58,15026.12
1989.03.27 13:00,t/p,194,1.07,1.07353,1.07982,1.07353,624.02,15650.14
1989.03.29 14:00,s/l,195,1.10,1.06996,1.06996,1.06281,-426.69,15223.45
1989.03.30 16:00,s/l,196,1.15,1.06846,1.06846,1.07505,-303.60,14919.85
1989.04.14 07:00,s/l,197,1.06,1.07670,1.07670,1.08369,-318.85,14601.00
1989.04.17 09:00,s/l,198,1.13,1.08712,1.08712,1.09358,-257.64,14343.36
1989.04.18 10:00,s/l,199,0.76,1.08446,1.08446,1.09493,-284.85,14058.51
1989.04.20 22:00,s/l,200,0.90,1.09240,1.09240,1.10014,-252.00,13806.51
1989.04.21 01:00,s/l,201,0.71,1.09042,1.09042,1.10129,-276.05,13530.47
1989.04.25 09:00,t/p,202,0.91,1.08346,1.09103,1.08346,484.21,14014.68
1989.04.25 15:00,close,203,0.74,1.08430,1.08963,1.08003,190.99,14205.67
1989.04.28 16:00,s/l,204,0.89,1.07614,1.07614,1.06804,-128.16,14077.51
1989.05.09 18:00,close,205,0.68,1.05670,1.06159,1.05013,53.11,14130.62
1989.05.12 06:00,close,206,0.72,1.05500,1.05912,1.04870,56.23,14186.85
1989.05.12 15:00,s/l,207,0.83,1.05980,1.05980,1.06830,-282.20,13904.65
1989.05.15 09:00,t/p,208,0.79,1.04197,1.05069,1.04197,413.17,14317.82
1989.05.18 02:00,s/l,209,0.65,1.02934,1.02934,1.01823,-116.80,14201.02
1989.05.18 12:00,t/p,210,0.60,1.01902,1.03237,1.01902,514.80,14715.82
1989.05.22 09:00,t/p,211,0.61,1.00605,1.01796,1.00605,411.75,15127.57
1989.05.23 07:00,s/l,212,0.53,1.01175,1.01175,0.99594,-300.46,14827.11
1989.05.26 12:00,t/p,213,0.46,1.03298,1.01528,1.03298,914.11,15741.22
1989.05.26 15:00,s/l,214,0.47,1.01900,1.01900,1.03775,-314.90,15426.32
1989.05.30 05:00,s/l,215,0.51,1.01084,1.01084,0.99573,-309.01,15117.31
1989.06.06 15:00,s/l,216,0.39,1.02237,1.02237,1.00034,-76.83,15040.48
1989.06.09 13:00,t/p,217,0.59,1.01059,1.02344,1.01059,448.99,15489.47
1989.06.14 15:00,close,218,0.40,0.99820,1.00530,0.98401,-21.52,15467.95
1989.06.16 08:00,s/l,219,0.50,1.01245,1.01245,1.02857,87.10,15555.05
1989.06.22 01:00,t/p,220,0.50,1.03608,1.02062,1.03608,462.80,16017.85
1989.06.22 16:00,s/l,221,0.42,1.02910,1.02910,1.05039,-319.20,15698.65
1989.06.28 15:00,s/l,222,0.50,1.03068,1.03068,1.01499,-314.00,15384.65
1989.07.04 04:00,t/p,223,0.54,1.05567,1.04155,1.05567,456.95,15841.60
1989.07.07 13:00,close,224,0.45,1.07700,1.06523,1.08475,215.64,16057.24
1989.07.11 01:00,s/l,225,0.63,1.07922,1.07922,1.09191,-263.84,15793.40
1989.07.13 16:00,close,226,0.45,1.07410,1.08376,1.06427,118.08,15911.48
1989.07.14 14:00,t/p,227,0.61,1.06219,1.07521,1.06219,475.25,16386.73
1989.07.14 14:00,close,228,0.52,1.06510,1.07545,1.05850,223.60,16610.33
1989.07.18 12:00,close,230,0.53,1.05050,1.06295,1.04518,322.29,16932.62
1989.07.18 13:00,t/p,229,0.61,1.04995,1.06386,1.04995,714.43,17647.05
1989.07.28 19:00,s/l,231,0.72,1.07582,1.07582,1.06427,-38.81,17608.24
1989.08.02 20:00,s/l,232,0.77,1.08746,1.08746,1.09881,-404.10,17204.15
1989.08.04 00:00,s/l,233,0.74,1.08150,1.08150,1.06999,-341.81,16862.34
1989.08.07 08:00,t/p,234,0.69,1.05778,1.07015,1.05778,531.37,17393.71
1989.08.08 13:00,s/l,235,0.55,1.06700,1.06700,1.04936,-347.55,17046.17
1989.08.14 18:00,close,236,0.53,1.04150,1.05093,1.03293,449.49,17495.66
1989.08.18 14:00,s/l,237,0.64,1.03238,1.03238,1.01892,-345.54,17150.12
1989.08.21 17:00,s/l,238,0.52,1.03604,1.03604,1.01744,-347.26,16802.87
1989.08.23 12:00,s/l,239,0.71,1.03679,1.03679,1.04857,-299.48,16503.39
1989.08.30 17:00,s/l,240,0.59,1.03662,1.03662,1.05224,-329.69,16173.70
1989.08.31 18:00,t/p,241,0.75,1.02903,1.03981,1.02903,420.98,16594.67
1989.09.07 20:00,s/l,242,0.85,1.01978,1.01978,1.01008,-329.80,16264.87
1989.09.11 13:00,s/l,243,0.82,1.01583,1.01583,1.00600,-322.26,15942.61
1989.09.15 17:00,s/l,244,0.85,1.01386,1.01386,1.00422,-107.10,15835.51
1989.09.15 19:00,s/l,245,0.61,1.02083,1.02083,1.00647,-312.93,15522.58
1989.09.21 10:00,s/l,246,0.70,1.03824,1.03824,1.04940,-145.88,15376.70
1989.09.26 02:00,s/l,247,0.60,1.05744,1.05744,1.07010,-304.08,15072.62
1989.09.26 02:00,s/l,248,0.55,1.05711,1.05711,1.07276,-307.89,14764.73
1989.10.02 05:00,s/l,249,0.48,1.07697,1.07697,1.09414,-141.02,14623.71
1989.10.10 17:00,t/p,250,0.71,1.05943,1.06972,1.05943,438.07,15061.78
1989.10.11 05:00,s/l,251,0.69,1.06512,1.06512,1.05431,-451.19,14610.59
1989.10.13 20:00,t/p,252,0.64,1.07571,1.06436,1.07571,435.84,15046.43
1989.10.16 11:00,t/p,253,0.59,1.09578,1.08314,1.09578,459.02,15505.45
1989.10.16 17:00,s/l,254,0.49,1.08239,1.08239,1.10006,-309.19,15196.26
1989.10.25 16:00,s/l,255,0.55,1.09714,1.09714,1.11079,-300.74,14895.52
1989.10.26 07:00,s/l,256,0.46,1.09526,1.09526,1.11358,-302.31,14593.21
1989.10.27 09:00,s/l,257,0.62,1.09328,1.09328,1.08158,-290.16,14303.05
1989.11.06 11:00,s/l,258,0.83,1.09240,1.09240,1.08364,-83.00,14220.05
1989.11.10 17:00,t/p,259,0.90,1.08562,1.09376,1.08562,680.49,14900.54
1989.11.13 01:00,s/l,260,1.06,1.08517,1.08517,1.07800,-51.83,14848.70
1989.11.14 01:00,s/l,261,0.72,1.08900,1.08900,1.07753,-296.57,14552.13
1989.11.15 01:00,s/l,262,0.91,1.09836,1.09836,1.10671,177.63,14729.77
1989.11.16 14:00,s/l,263,0.68,1.09470,1.09470,1.10673,-287.23,14442.53
1989.11.22 09:00,t/p,264,0.79,1.11695,1.10786,1.11695,429.92,14872.45
1989.11.22 09:00,t/p,265,0.66,1.11735,1.10530,1.11735,510.97,15383.42
1989.11.24 15:00,s/l,266,0.67,1.11765,1.11765,1.13038,-304.85,15078.57
1989.12.07 16:00,s/l,267,0.70,1.14050,1.14050,1.15150,-183.68,14894.89
1989.12.08 14:00,s/l,268,0.66,1.14461,1.14461,1.13334,-298.91,14595.98
1989.12.12 14:00,t/p,269,0.57,1.15750,1.14335,1.15750,518.70,15114.68
1989.12.12 17:00,t/p,270,0.56,1.16489,1.14997,1.16489,537.04,15651.72
1989.12.13 10:00,s/l,271,0.52,1.17221,1.17221,1.18899,-311.48,15340.24
1989.12.19 02:00,s/l,272,0.59,1.16721,1.16721,1.18044,-218.65,15121.59
1989.12.26 16:00,close,273,0.48,1.18830,1.18374,1.20127,-81.60,15039.99
1989.12.28 09:00,t/p,274,0.58,1.20414,1.19124,1.20414,522.93,15562.91
1990.01.04 01:00,close,275,0.43,1.16790,1.18253,1.16256,320.05,15882.96
1990.01.05 07:00,s/l,276,0.43,1.19543,1.19543,1.21578,-312.61,15570.35
1990.01.16 17:00,s/l,277,0.37,1.19558,1.19558,1.17240,-306.36,15263.99
1990.01.18 08:00,s/l,278,0.40,1.19124,1.19124,1.21014,-303.36,14960.63
1990.01.22 18:00,close,279,0.34,1.16960,1.18912,1.16498,369.95,15330.59
1990.01.31 01:00,s/l,280,0.50,1.19503,1.19503,1.17970,-307.45,15023.14
1990.02.13 23:00,s/l,281,0.48,1.20721,1.20721,1.18982,-298.08,14725.06
1990.02.16 15:00,s/l,282,0.65,1.19794,1.19794,1.18658,-302.84,14422.22
1990.03.01 02:00,t/p,283,0.66,1.18142,1.19222,1.18142,252.32,14674.54
1990.03.07 22:00,s/l,284,0.53,1.19087,1.19087,1.17556,-289.91,14384.63
1990.03.08 16:00,s/l,285,0.64,1.18657,1.18657,1.19764,-285.06,14099.57
1990.03.12 17:00,t/p,286,0.66,1.17956,1.19012,1.17956,417.19,14516.76
1990.03.13 10:00,close,287,0.57,1.17970,1.18483,1.17075,4.62,14521.38
1990.03.16 17:00,close,289,0.61,1.19240,1.18563,1.19899,121.51,14642.89
1990.03.19 07:00,t/p,288,0.73,1.19573,1.18568,1.19573,628.82,15271.71
1990.03.20 04:00,s/l,290,0.58,1.19557,1.19557,1.21021,-303.80,14967.91
1990.03.21 23:00,t/p,291,0.74,1.17894,1.18921,1.17894,580.23,15548.14
1990.03.26 10:00,s/l,292,0.77,1.18003,1.18003,1.16996,-310.31,15237.83
1990.04.10 17:00,t/p,293,0.94,1.19746,1.18936,1.19746,398.94,15636.77
1990.04.12 01:00,t/p,294,1.03,1.21082,1.20262,1.21082,1069.96,16706.73
1990.04.16 17:00,t/p,295,1.42,1.20029,1.20648,1.20029,853.42,17560.15
1990.04.17 03:00,close,296,0.91,1.20050,1.20604,1.19528,152.97,17713.12
1990.04.19 04:00,s/l,297,1.24,1.20584,1.20584,1.21300,-295.62,17417.51
1990.04.20 16:00,t/p,298,1.14,1.19794,1.20570,1.19794,586.07,18003.58
1990.04.23 03:00,t/p,299,1.12,1.19233,1.20044,1.19233,498.51,18502.09
1990.04.23 22:00,t/p,300,1.11,1.18724,1.19551,1.18724,550.56,19052.65
1990.04.24 06:00,s/l,301,1.03,1.18967,1.18967,1.17939,-379.97,18672.68
1990.04.26 11:00,t/p,302,1.10,1.20642,1.19756,1.20642,912.56,19585.24
1990.04.27 17:00,close,303,0.91,1.20780,1.19771,1.20944,533.99,20119.23
1990.05.04 19:00,t/p,304,1.18,1.21368,1.20522,1.21368,599.44,20718.67
1990.05.08 01:00,close,305,0.95,1.21990,1.21658,1.22924,350.74,21069.41
1990.05.09 16:00,t/p,306,1.31,1.23381,1.22579,1.23381,564.61,21634.02
1990.05.10 14:00,s/l,307,0.94,1.23023,1.23023,1.24303,-431.84,21202.19
1990.05.30 14:00,s/l,308,1.02,1.20446,1.20446,1.21482,-627.10,20575.09
1990.06.01 15:00,s/l,309,0.96,1.19582,1.19582,1.20676,-180.48,20394.61
1990.06.12 01:00,s/l,310,1.05,1.19649,1.19649,1.18676,-340.94,20053.68
1990.06.15 16:00,s/l,311,1.13,1.19273,1.19273,1.18391,-455.39,19598.29
1990.06.19 16:00,close,312,0.77,1.21010,1.20013,1.21433,376.68,19974.97
1990.06.20 00:00,s/l,313,1.15,1.20613,1.20613,1.21481,-480.47,19494.50
1990.06.28 10:00,s/l,315,0.94,1.21221,1.21221,1.22423,-273.92,19220.58
1990.06.28 17:00,s/l,314,1.06,1.21020,1.21020,1.21946,-130.59,19089.99
1990.07.09 17:00,s/l,316,1.06,1.22361,1.22361,1.23258,-380.54,18709.45
1990.07.18 15:00,close,317,0.73,1.23380,1.22378,1.23839,422.82,19132.27
1990.07.24 17:00,close,318,0.71,1.25070,1.24071,1.25580,326.03,19458.30
1990.07.24 21:00,s/l,319,0.79,1.24601,1.24601,1.25823,-386.31,19071.99
1990.07.30 13:00,t/p,320,0.95,1.25660,1.24660,1.25660,569.24,19641.23
1990.07.31 17:00,t/p,321,0.95,1.27402,1.26349,1.27402,723.90,20365.13
1990.08.01 08:00,close,322,0.66,1.27230,1.26635,1.28217,-7.13,20358.00
1990.08.02 12:00,t/p,323,0.80,1.24932,1.26195,1.24932,502.40,20860.40
1990.08.07 18:00,s/l,324,0.62,1.27738,1.27738,1.29592,-410.94,20449.47
1990.08.09 19:00,close,325,0.61,1.26550,1.27702,1.25849,295.42,20744.89
1990.08.14 15:00,t/p,326,0.70,1.28618,1.27138,1.28618,621.04,21365.93
1990.08.15 14:00,t/p,327,0.72,1.29996,1.28519,1.29996,846.14,22212.07
1990.08.15 15:00,close,328,0.61,1.29870,1.28566,1.30537,366.00,22578.07
1990.08.17 00:00,s/l,329,0.81,1.29713,1.29713,1.31105,-208.82,22369.25
1990.08.30 16:00,close,330,0.65,1.29050,1.29660,1.27756,-45.50,22323.75
1990.09.04 00:00,close,331,0.64,1.27600,1.28276,1.26328,-14.02,22309.74
1990.09.14 02:00,t/p,332,0.77,1.29375,1.27934,1.29375,773.23,23082.97
1990.09.20 14:00,close,334,0.63,1.28000,1.29207,1.27144,296.10,23379.07
1990.09.20 15:00,t/p,333,0.74,1.27914,1.29457,1.27914,777.22,24156.29
1990.09.25 19:00,s/l,335,0.78,1.28657,1.28657,1.30189,-478.76,23677.53
1990.09.26 18:00,s/l,336,0.74,1.29166,1.29166,1.27575,-472.05,23205.48
1990.09.27 16:00,close,337,0.64,1.28650,1.29382,1.27332,-3.65,23201.84
1990.09.28 03:00,s/l,338,0.79,1.29018,1.29018,1.30472,-460.41,22741.42
1990.10.01 17:00,s/l,339,0.81,1.29924,1.29924,1.31314,-434.16,22307.26
1990.10.04 12:00,t/p,340,0.62,1.31643,1.29647,1.31643,793.97,23101.24
1990.10.05 20:00,s/l,341,0.85,1.30736,1.30736,1.29320,-132.60,22968.64
1990.10.11 17:00,s/l,342,0.89,1.32405,1.32405,1.31118,-556.25,22412.39
1990.10.18 19:00,t/p,343,0.86,1.34546,1.33170,1.34546,1206.41,23618.79
1990.10.23 13:00,s/l,344,0.86,1.33524,1.33524,1.32163,-469.47,23149.32
1990.10.25 16:00,s/l,345,0.83,1.33586,1.33586,1.35021,-113.21,23036.11
1990.10.25 17:00,s/l,346,0.67,1.33415,1.33415,1.35360,-465.65,22570.46
1990.10.29 00:00,s/l,347,0.86,1.33968,1.33968,1.32623,-388.55,22181.91
1990.10.29 15:00,s/l,348,0.82,1.33420,1.33420,1.34771,-442.80,21739.11
1990.11.05 18:00,t/p,349,0.87,1.36032,1.34796,1.36032,645.54,22384.65
1990.11.15 10:00,s/l,351,0.94,1.36878,1.36878,1.38109,-220.34,22164.31
1990.11.16 15:00,close,350,0.70,1.37550,1.36008,1.37778,633.64,22797.95
1990.11.19 17:00,s/l,352,1.04,1.37074,1.37074,1.38163,-454.27,22343.68
1990.11.26 10:00,t/p,353,1.23,1.35639,1.36540,1.35639,663.09,23006.78
1990.11.27 17:00,s/l,354,0.93,1.36581,1.36581,1.35234,-449.10,22557.68
1990.11.27 23:00,s/l,355,1.15,1.36439,1.36439,1.37441,-127.65,22430.03
1990.11.29 21:00,s/l,356,0.99,1.34507,1.34507,1.33339,12.87,22442.90
1990.12.10 19:00,close,357,0.69,1.37360,1.36942,1.38756,-158.70,22284.20
1990.12.12 11:00,s/l,358,0.75,1.37132,1.37132,1.35653,-445.43,21838.77
1990.12.14 16:00,s/l,359,0.86,1.36454,1.36454,1.35193,-433.44,21405.33
1990.12.20 10:00,s/l,360,0.96,1.36448,1.36448,1.37454,-456.19,20949.14
1990.12.20 17:00,t/p,361,0.99,1.34649,1.35767,1.34649,1218.69,22167.83
1990.12.21 15:00,t/p,362,0.67,1.32684,1.34513,1.32684,787.92,22955.75
1991.01.02 00:00,close,363,0.61,1.35450,1.33882,1.35921,565.84,23521.59
1991.01.07 07:00,t/p,364,0.62,1.33045,1.34953,1.33045,690.12,24211.71
1991.01.08 12:00,close,365,0.54,1.31520,1.32624,1.30149,117.77,24329.48
1991.01.14 16:00,s/l,366,0.66,1.30816,1.30816,1.28975,-294.36,24035.12
1991.01.17 20:00,t/p,367,0.65,1.34098,1.32185,1.34098,1435.20,25470.32
1991.01.18 01:00,s/l,368,0.53,1.33085,1.33085,1.35759,-506.57,24963.75
1991.01.25 15:00,s/l,369,0.68,1.35606,1.35606,1.37440,-426.50,24537.25
1991.01.29 18:00,s/l,370,0.79,1.35659,1.35659,1.37211,-419.49,24117.76
1991.01.30 18:00,s/l,371,0.74,1.35603,1.35603,1.33971,-381.03,23736.74
1991.02.06 18:00,t/p,372,0.96,1.39437,1.38192,1.39437,917.95,24654.69
1991.02.07 02:00,s/l,373,1.04,1.39155,1.39155,1.40342,-454.90,24199.79
1991.02.13 14:00,s/l,374,0.99,1.38908,1.38908,1.37688,-483.12,23716.67
1991.02.25 14:00,t/p,375,0.86,1.33300,1.34666,1.33300,909.97,24626.64
1991.02.26 05:00,s/l,376,0.76,1.33573,1.33573,1.31773,-490.12,24136.52
1991.03.11 10:00,s/l,377,0.85,1.28556,1.28556,1.27140,-481.10,23655.42
1991.03.11 13:00,s/l,378,0.64,1.28788,1.28788,1.26693,-478.72,23176.70
1991.03.18 13:00,t/p,379,0.74,1.24941,1.26489,1.24941,686.05,23862.75
1991.03.19 11:00,s/l,380,0.59,1.24842,1.24842,1.22596,-474.30,23388.45
1991.03.19 16:00,s/l,381,0.59,1.22743,1.22743,1.20785,-461.97,22926.48
1991.03.25 11:00,t/p,382,0.57,1.21366,1.23389,1.21366,844.80,23771.28
1991.03.26 15:00,close,383,0.49,1.19310,1.21062,1.18396,910.47,24681.74
1991.04.01 14:00,s/l,384,0.58,1.19566,1.19566,1.21677,-489.52,24192.22
1991.04.09 10:00,s/l,385,0.63,1.20298,1.20298,1.18378,-485.04,23707.19
1991.04.10 08:00,t/p,386,0.60,1.21601,1.19632,1.21601,708.12,24415.31
1991.04.11 15:00,s/l,387,0.61,1.20830,1.20830,1.18855,-485.38,23929.93
1991.04.15 01:00,s/l,388,0.61,1.20439,1.20439,1.18441,-31.05,23898.88
1991.04.22 02:00,t/p,389,0.51,1.15696,1.18331,1.15696,1163.87,25062.75
1991.04.23 01:00,s/l,390,0.51,1.15607,1.15607,1.12871,-499.24,24563.51
1991.04.29 09:00,s/l,391,0.70,1.14502,1.14502,1.12771,-526.40,24037.11
1991.04.30 17:00,t/p,392,0.54,1.18179,1.15707,1.18179,858.06,24895.17
1991.05.01 17:00,s/l,393,0.53,1.18174,1.18174,1.20766,-490.78,24404.39
1991.05.07 08:00,s/l,394,0.62,1.17085,1.17085,1.15123,-489.06,23915.34
1991.05.09 18:00,s/l,395,0.63,1.16707,1.16707,1.14814,-439.11,23476.23
1991.05.15 17:00,t/p,396,0.70,1.20138,1.18425,1.20138,901.04,24377.27
1991.05.20 01:00,t/p,397,0.80,1.15460,1.17027,1.15460,886.48,25263.75
1991.05.20 16:00,s/l,398,0.54,1.16683,1.16683,1.14070,-503.82,24759.93
1991.05.24 17:00,close,400,0.65,1.18490,1.17443,1.19591,182.00,24941.93
1991.05.27 01:00,t/p,399,0.74,1.18933,1.17262,1.18933,741.04,25682.96
1991.05.31 13:00,t/p,401,0.85,1.16945,1.18520,1.16945,1272.79,26955.75
1991.06.05 06:00,s/l,402,1.05,1.15649,1.15649,1.16926,-537.39,26418.36
1991.06.10 04:00,t/p,403,1.06,1.13699,1.14951,1.13699,529.05,26947.41
1991.06.11 16:00,close,404,0.78,1.13930,1.15112,1.13258,402.64,27350.05
1991.06.13 12:00,t/p,405,1.25,1.12105,1.13263,1.12105,1649.13,28999.17
1991.06.17 19:00,close,406,0.92,1.12500,1.13289,1.11696,377.66,29376.83
1991.06.19 08:00,s/l,407,1.08,1.11734,1.11734,1.10211,-589.57,28787.26
1991.06.20 12:00,s/l,408,0.98,1.12983,1.12983,1.14711,225.99,29013.25
1991.06.25 08:00,s/l,409,0.94,1.12767,1.12767,1.14483,-576.22,28437.03
1991.06.27 12:00,s/l,410,1.00,1.12663,1.12663,1.14081,-729.40,27707.63
1991.07.02 14:00,close,412,0.82,1.10290,1.11334,1.09447,303.40,28011.03
1991.07.05 01:00,t/p,411,0.92,1.09749,1.11251,1.09749,836.83,28847.86
1991.07.12 09:00,s/l,413,1.31,1.10666,1.10666,1.09526,-115.15,28732.71
1991.07.12 10:00,s/l,414,0.93,1.11286,1.11286,1.09562,-572.88,28159.83
1991.07.19 07:00,t/p,415,0.92,1.14702,1.13003,1.14702,1003.90,29163.73
1991.07.19 08:00,t/p,416,1.09,1.14851,1.13550,1.14851,850.42,30014.15
1991.07.19 22:00,t/p,417,1.13,1.15802,1.14466,1.15802,985.36,30999.51
1991.08.02 13:00,s/l,418,1.07,1.15624,1.15624,1.14163,-519.91,30479.60
1991.08.02 13:00,s/l,419,0.84,1.15138,1.15138,1.13296,-58.72,30420.88
1991.08.06 18:00,close,420,0.83,1.18260,1.16879,1.18926,538.84,30959.72
1991.08.14 08:00,t/p,421,1.19,1.16294,1.17587,1.16294,916.66,31876.38
1991.08.15 17:00,s/l,422,1.23,1.16393,1.16393,1.17685,-635.91,31240.47
1991.08.19 05:00,t/p,423,1.23,1.12212,1.13476,1.12212,932.34,32172.81
1991.08.19 06:00,s/l,424,1.04,1.10918,1.10918,1.09373,-642.72,31530.09
1991.08.19 09:00,s/l,425,1.02,1.11568,1.11568,1.10023,-630.36,30899.73
1991.08.20 05:00,close,426,0.82,1.10810,1.12126,1.10009,457.64,31357.37
1991.08.20 17:00,s/l,427,0.91,1.11673,1.11673,1.13390,-625.17,30732.20
1991.08.28 17:00,s/l,428,0.72,1.16292,1.16292,1.14163,-617.54,30114.65
1991.09.06 17:00,t/p,429,1.74,1.16908,1.16044,1.16908,901.32,31015.97
1991.09.06 18:00,t/p,430,1.78,1.17550,1.16683,1.17550,925.60,31941.57
1991.09.09 07:00,s/l,431,1.70,1.18032,1.18032,1.18976,-574.60,31366.97
1991.09.10 15:00,s/l,432,0.96,1.19086,1.19086,1.20973,-148.61,31218.37
1991.09.24 09:00,s/l,433,1.08,1.20356,1.20356,1.21963,-620.78,30597.58
1991.10.02 05:00,close,435,1.04,1.21270,1.20842,1.22545,-240.86,30356.72
1991.10.03 01:00,s/l,436,1.09,1.21072,1.21072,1.22690,-632.64,29724.08
1991.10.04 14:00,s/l,434,1.24,1.20843,1.20843,1.21986,343.98,30068.06
1991.10.04 17:00,t/p,437,1.39,1.20014,1.21090,1.20014,897.94,30966.00
1991.10.04 20:00,s/l,438,1.36,1.20524,1.20524,1.19388,-617.44,30348.56
1991.10.08 18:00,t/p,439,1.53,1.19042,1.20039,1.19042,1113.84,31462.40
1991.10.09 15:00,s/l,440,1.11,1.18946,1.18946,1.17361,-628.26,30834.14
1991.10.17 20:00,s/l,441,1.09,1.19262,1.19262,1.17688,-620.86,30213.27
1991.10.21 12:00,t/p,442,1.18,1.19924,1.18650,1.19924,899.63,31112.91
1991.10.29 14:00,s/l,443,1.23,1.18084,1.18084,1.16673,-619.92,30492.99
1991.10.29 17:00,t/p,444,1.47,1.19790,1.18756,1.19790,911.40,31404.39
1991.10.29 19:00,t/p,445,1.42,1.20179,1.19080,1.20179,907.38,32311.77
1991.10.30 17:00,t/p,446,1.20,1.20654,1.19155,1.20654,1156.80,33468.57
1991.10.31 09:00,s/l,447,1.40,1.20584,1.20584,1.21773,-669.76,32798.81
1991.11.04 17:00,t/p,448,1.29,1.23882,1.22596,1.23882,1884.95,34683.75
1991.11.05 09:00,s/l,449,1.13,1.22851,1.22851,1.24528,-677.77,34005.98
1991.11.11 19:00,s/l,450,1.18,1.23454,1.23454,1.22020,-681.80,33324.18
1991.11.18 22:00,s/l,451,1.50,1.25337,1.25337,1.26445,-799.50,32524.68
1991.11.26 11:00,s/l,452,1.11,1.26888,1.26888,1.28518,-646.91,31877.77
1991.11.26 21:00,s/l,453,1.02,1.25424,1.25424,1.23863,-636.48,31241.29
1991.11.29 18:00,s/l,454,0.90,1.24516,1.24516,1.22540,-338.40,30902.89
1991.12.04 17:00,s/l,455,1.05,1.25104,1.25104,1.26568,-616.14,30286.75
1991.12.10 06:00,t/p,456,1.00,1.29355,1.27813,1.29355,983.40,31270.15
1991.12.17 17:00,s/l,457,1.14,1.28315,1.28315,1.29678,-621.30,30648.85
1991.12.19 14:00,s/l,458,1.17,1.29139,1.29139,1.30442,-609.57,30039.28
1991.12.20 08:00,t/p,459,1.14,1.29940,1.28624,1.29940,899.69,30938.97
1991.12.20 15:00,t/p,460,1.17,1.31787,1.30476,1.31787,920.79,31859.76
1991.12.23 11:00,t/p,461,1.13,1.32543,1.31138,1.32543,985.59,32845.34
1991.12.24 03:00,s/l,462,0.89,1.32909,1.32909,1.34956,-651.30,32194.04
1991.12.30 01:00,t/p,463,1.07,1.32355,1.33847,1.32355,955.62,33149.66
1992.01.08 10:00,s/l,464,1.03,1.33484,1.33484,1.35099,-604.40,32545.25
1992.01.09 08:00,s/l,465,1.02,1.32827,1.32827,1.31234,-965.94,31579.31
1992.01.15 10:00,t/p,466,0.71,1.25262,1.27459,1.25262,934.43,32513.74
1992.01.16 09:00,s/l,467,0.63,1.25426,1.25426,1.22553,-649.97,31863.77
1992.01.24 16:00,s/l,468,0.78,1.26628,1.26628,1.24533,-530.32,31333.45
1992.01.27 00:00,s/l,469,0.77,1.26551,1.26551,1.28573,-623.55,30709.90
1992.01.29 19:00,s/l,470,0.74,1.25964,1.25964,1.28028,-611.83,30098.07
1992.01.30 21:00,s/l,471,0.76,1.25279,1.25279,1.23307,-599.64,29498.43
1992.02.04 14:00,t/p,472,0.81,1.26868,1.25054,1.26868,879.98,30378.42
1992.02.10 15:00,s/l,473,0.95,1.28646,1.28646,1.30255,-593.56,29784.86
1992.02.10 15:00,s/l,474,0.76,1.28633,1.28633,1.30893,-658.92,29125.94
1992.02.12 10:00,close,475,0.70,1.26340,1.28003,1.25587,1391.67,30517.61
1992.02.17 10:00,s/l,476,0.91,1.24913,1.24913,1.26580,-443.17,30074.44
1992.02.20 17:00,s/l,477,0.85,1.22740,1.22740,1.20965,214.54,30288.98
1992.02.25 18:00,s/l,478,0.94,1.22671,1.22671,1.24269,-957.86,29331.12
1992.02.27 17:00,s/l,479,0.69,1.22584,1.22584,1.24953,-583.74,28747.38
1992.03.02 12:00,s/l,480,1.06,1.23518,1.23518,1.22173,-570.28,28177.10
1992.03.06 12:00,s/l,481,0.99,1.21435,1.21435,1.20023,-556.97,27620.12
1992.03.09 10:00,s/l,482,1.06,1.21239,1.21239,1.22542,-499.26,27120.86
1992.03.11 16:00,s/l,483,1.12,1.21311,1.21311,1.20109,-540.85,26580.01
1992.03.17 14:00,s/l,484,0.89,1.21739,1.21739,1.23394,-525.99,26054.02
1992.03.20 16:00,close,485,0.91,1.20090,1.21087,1.19500,1244.97,27299.00
1992.03.27 13:00,s/l,486,1.24,1.22030,1.22030,1.20930,-547.96,26751.04
1992.03.30 14:00,s/l,487,1.13,1.22508,1.22508,1.23687,-534.26,26216.78
1992.04.03 08:00,t/p,488,1.15,1.23535,1.22376,1.23535,901.83,27118.61
1992.04.03 14:00,t/p,489,0.94,1.23796,1.22247,1.23796,936.24,28054.85
1992.04.27 01:00,s/l,490,1.07,1.21829,1.21829,1.23288,-558.33,27496.52
1992.04.28 16:00,s/l,491,1.09,1.22262,1.22262,1.20856,-547.18,26949.34
1992.05.01 15:00,t/p,492,1.74,1.23053,1.22281,1.23053,804.23,27753.57
1992.05.01 15:00,close,493,1.27,1.22980,1.22323,1.23518,292.10,28045.67
1992.05.13 05:00,t/p,494,1.21,1.24670,1.23379,1.24670,1003.33,29049.00
1992.05.19 08:00,close,495,1.06,1.26980,1.26032,1.27566,423.15,29472.15
1992.05.19 22:00,s/l,496,1.24,1.26576,1.26576,1.27762,-525.76,28946.39
1992.05.28 13:00,s/l,497,0.99,1.24071,1.24071,1.22444,-580.83,28365.56
1992.06.01 05:00,t/p,498,0.94,1.26664,1.24978,1.26664,858.41,29223.97
1992.06.12 13:00,t/p,499,1.16,1.28715,1.27457,1.28715,816.87,30040.84
1992.06.17 14:00,s/l,500,1.03,1.28407,1.28407,1.30039,-600.49,29440.35
1992.06.26 08:00,close,501,0.99,1.31290,1.30670,1.32238,226.91,29667.26
1992.06.29 15:00,t/p,502,1.15,1.33179,1.31897,1.33179,884.35,30551.61
1992.07.06 10:00,s/l,503,0.87,1.33080,1.33080,1.31120,-609.00,29942.61
1992.07.08 01:00,t/p,504,0.95,1.35964,1.34358,1.35964,991.04,30933.65
1992.07.08 15:00,s/l,505,0.84,1.34817,1.34817,1.36841,-607.32,30326.33
1992.07.14 09:00,s/l,506,0.67,1.36070,1.36070,1.38617,-87.64,30238.69
1992.07.20 15:00,s/l,507,0.63,1.37957,1.37957,1.40625,-600.39,29638.30
1992.07.28 12:00,close,508,0.57,1.36770,1.35462,1.38368,153.90,29792.20
1992.07.31 02:00,s/l,509,0.73,1.36988,1.36988,1.34942,-303.39,29488.81
1992.08.07 13:00,s/l,510,1.15,1.36911,1.36911,1.35634,-952.89,28535.92
1992.08.07 17:00,s/l,511,1.22,1.37430,1.37430,1.38631,61.00,28596.92
1992.08.11 17:00,s/l,512,1.23,1.37594,1.37594,1.36433,-570.72,28026.20
1992.08.14 08:00,s/l,513,1.29,1.38317,1.38317,1.39424,-95.20,27931.00
1992.08.14 10:00,s/l,514,1.00,1.38153,1.38153,1.39741,-567.80,27363.20
1992.08.18 07:00,s/l,515,0.89,1.38431,1.38431,1.36720,-547.17,26816.03
1992.08.24 00:00,t/p,516,0.99,1.41848,1.40502,1.41848,799.13,27615.16
1992.08.24 14:00,t/p,517,1.02,1.42861,1.41509,1.42861,745.62,28360.78
1992.09.04 10:00,t/p,518,0.80,1.41852,1.43616,1.41852,1100.88,29461.66
1992.09.04 13:00,s/l,519,0.72,1.42265,1.42265,1.39984,-586.80,28874.86
1992.09.09 07:00,s/l,520,0.88,1.44307,1.44307,1.45940,-548.94,28325.91
1992.09.09 18:00,t/p,521,0.83,1.43099,1.44800,1.43099,847.43,29173.34
1992.09.10 15:00,s/l,522,0.63,1.43365,1.43365,1.40804,-576.45,28596.89
1992.09.14 09:00,s/l,523,0.59,1.36421,1.36421,1.34019,-561.09,28035.80
1992.09.23 15:00,s/l,524,0.38,1.35105,1.35105,1.31058,-549.10,27486.70
1992.09.29 20:00,t/p,525,0.46,1.43403,1.40464,1.43403,810.98,28297.68
1992.09.30 02:00,t/p,526,0.36,1.44199,1.39985,1.44199,974.95,29272.63
1992.10.01 03:00,s/l,527,0.38,1.41528,1.41528,1.45790,-579.27,28693.36
1992.10.01 09:00,s/l,528,0.56,1.42792,1.42792,1.40236,-572.32,28121.04
1992.10.08 02:00,t/p,529,0.53,1.38478,1.41164,1.38478,904.34,29025.38
1992.10.09 02:00,t/p,530,0.44,1.35388,1.39078,1.35388,1042.84,30068.23
1992.10.26 13:00,t/p,531,0.67,1.30870,1.33104,1.30870,896.53,30964.75
1992.10.28 00:00,s/l,532,0.51,1.32494,1.32494,1.29151,-610.88,30353.87
1992.11.03 15:00,s/l,534,0.57,1.29385,1.29385,1.26486,-220.53,30133.34
1992.11.04 01:00,s/l,533,0.72,1.30190,1.30190,1.28089,-607.54,29525.81
1992.11.16 08:00,s/l,535,0.69,1.27966,1.27966,1.30330,-582.91,28942.89
1992.12.02 09:00,s/l,536,0.96,1.28047,1.28047,1.29654,188.35,29131.25
1992.12.07 04:00,s/l,537,1.10,1.27109,1.27109,1.25762,-286.99,28844.26
1992.12.09 09:00,s/l,538,0.72,1.28609,1.28609,1.30852,-562.90,28281.36
1992.12.10 14:00,s/l,539,0.92,1.28432,1.28432,1.26901,-425.04,27856.32
1992.12.17 11:00,t/p,540,1.01,1.30633,1.29262,1.30633,828.81,28685.13
1992.12.17 15:00,s/l,541,1.01,1.30084,1.30084,1.31498,-571.66,28113.47
1992.12.22 19:00,t/p,542,1.21,1.27071,1.28236,1.27071,857.89,28971.36
1992.12.24 06:00,close,543,0.88,1.27050,1.27733,1.25877,285.38,29256.74
1992.12.28 20:00,t/p,544,0.90,1.24970,1.26790,1.24970,1053.00,30309.74
1992.12.29 17:00,s/l,545,1.21,1.25190,1.25190,1.23939,-607.30,29702.44
1993.01.05 17:00,s/l,546,0.98,1.23222,1.23222,1.21537,-589.96,29112.48
1993.01.08 17:00,s/l,547,0.91,1.23054,1.23054,1.21279,-576.94,28535.54
1993.01.12 06:00,close,548,0.90,1.23780,1.23207,1.24979,-54.72,28480.82
1993.01.19 16:00,close,549,0.98,1.25310,1.24180,1.25804,539.00,29019.82
1993.01.22 17:00,t/p,550,1.25,1.26536,1.25376,1.26536,870.00,29889.82
1993.01.25 14:00,t/p,551,1.20,1.27289,1.26040,1.27289,741.84,30631.66
1993.01.26 14:00,close,552,0.96,1.28390,1.27217,1.28990,517.63,31149.29
1993.02.01 03:00,t/p,553,1.04,1.23852,1.25349,1.23852,931.94,32081.24
1993.02.03 05:00,close,554,0.92,1.22680,1.23515,1.21513,879.70,32960.94
1993.02.05 15:00,s/l,555,1.02,1.21676,1.21676,1.20062,-660.86,32300.08
1993.02.16 16:00,t/p,556,1.55,1.21772,1.20719,1.21772,1196.60,33496.68
1993.02.18 03:00,s/l,557,1.03,1.22267,1.22267,1.24123,-304.26,33192.42
1993.02.23 02:00,close,558,1.05,1.22730,1.21399,1.23166,733.32,33925.74
1993.03.03 16:00,s/l,559,1.20,1.21139,1.21139,1.22710,-673.20,33252.54
1993.03.05 17:00,t/p,560,1.47,1.19524,1.20651,1.19524,993.72,34246.26
1993.03.11 11:00,t/p,561,1.47,1.19002,1.20165,1.19002,1014.89,35261.15
1993.03.18 19:00,t/p,562,1.85,1.20799,1.19850,1.20799,1052.65,36313.80
1993.03.19 16:00,t/p,563,1.76,1.21536,1.20509,1.21536,1364.35,37678.15
1993.03.19 16:00,t/p,564,1.42,1.21697,1.20270,1.21697,1302.14,38980.29
1993.03.31 17:00,t/p,565,1.83,1.23051,1.21982,1.23051,1519.27,40499.56
1993.04.01 16:00,t/p,566,1.66,1.23572,1.22231,1.23572,1426.94,41926.49
1993.04.02 19:00,s/l,567,1.70,1.23361,1.23361,1.22134,-834.70,41091.79
1993.04.13 09:00,t/p,568,1.56,1.24800,1.23584,1.24800,1961.86,43053.65
1993.04.14 11:00,s/l,569,1.64,1.25371,1.25371,1.26694,-639.27,42414.38
1993.04.14 14:00,s/l,570,1.38,1.25237,1.25237,1.26981,-860.84,41553.53
1993.04.15 16:00,close,571,1.33,1.24330,1.25484,1.23737,697.32,42250.85
1993.04.19 04:00,s/l,572,1.82,1.23852,1.23852,1.22697,-844.30,41406.55
1993.04.27 01:00,close,573,1.23,1.27290,1.26770,1.28645,-111.68,41294.87
1993.04.28 16:00,s/l,574,1.23,1.26398,1.26398,1.24528,-821.64,40473.23
1993.04.30 07:00,s/l,575,1.21,1.26256,1.26256,1.28115,-804.41,39668.82
1993.05.07 16:00,s/l,576,1.54,1.26918,1.26918,1.28198,-789.71,38879.11
1993.05.12 08:00,close,577,1.12,1.24140,1.25662,1.23836,757.34,39636.45
1993.05.18 08:00,t/p,578,1.82,1.23230,1.24330,1.23230,1197.74,40834.20
1993.05.19 02:00,close,579,1.47,1.23410,1.23924,1.22344,599.91,41434.10
1993.05.19 12:00,s/l,580,1.90,1.23501,1.23501,1.24598,-872.10,40562.00
1993.05.25 14:00,s/l,581,1.49,1.22972,1.22972,1.21454,-810.41,39751.59
1993.05.26 09:00,s/l,582,2.04,1.22808,1.22808,1.23789,-760.51,38991.08
1993.05.26 20:00,s/l,583,1.98,1.22972,1.22972,1.21991,-914.76,38076.32
1993.05.28 16:00,t/p,584,1.42,1.25389,1.23897,1.25389,1361.78,39438.10
1993.06.07 15:00,s/l,585,1.72,1.23519,1.23519,1.22321,325.25,39763.35
1993.06.10 18:00,close,586,1.85,1.22920,1.23197,1.22105,44.95,39808.31
1993.06.11 14:00,t/p,587,1.88,1.23553,1.22498,1.23553,1188.54,40996.84
1993.06.15 19:00,t/p,588,2.02,1.21732,1.22778,1.21732,1571.56,42568.40
1993.06.16 14:00,t/p,589,1.57,1.20984,1.22502,1.20984,1532.32,44100.72
1993.06.22 16:00,close,590,1.54,1.18370,1.19370,1.17775,659.27,44760.00
1993.06.23 13:00,s/l,592,1.60,1.18525,1.18525,1.16944,-904.00,43856.00
1993.06.23 15:00,s/l,591,1.86,1.18830,1.18830,1.17630,-896.33,42959.66
1993.06.25 07:00,s/l,593,1.60,1.18115,1.18115,1.16617,-856.00,42103.66
1993.06.29 17:00,s/l,594,1.66,1.18215,1.18215,1.19477,-838.30,41265.36
1993.07.01 12:00,s/l,596,1.38,1.17715,1.17715,1.15994,-848.70,40416.66
1993.07.01 13:00,s/l,595,1.70,1.18136,1.18136,1.16870,-376.89,40039.77
1993.07.06 15:00,s/l,597,1.74,1.17932,1.17932,1.16778,-647.28,39392.49
1993.07.13 11:00,s/l,598,1.33,1.15709,1.15709,1.14060,-785.90,38606.60
1993.07.14 09:00,s/l,599,1.79,1.15147,1.15147,1.16230,-776.50,37830.09
1993.07.14 09:00,s/l,600,1.41,1.15199,1.15199,1.16742,-776.91,37053.18
1993.07.19 16:00,t/p,601,1.84,1.16454,1.15448,1.16454,1111.36,38164.54
1993.07.20 18:00,s/l,602,1.76,1.16314,1.16314,1.15230,-975.04,37189.50
1993.07.29 15:00,t/p,603,1.91,1.13646,1.14619,1.13646,1115.44,38304.94
1993.07.30 08:00,t/p,604,1.84,1.13168,1.14204,1.13168,920.18,39225.13
1993.07.30 17:00,close,605,1.38,1.13020,1.13752,1.12291,701.18,39926.31
1993.08.03 15:00,close,607,1.48,1.14960,1.13727,1.15247,1021.20,40947.51
1993.08.03 16:00,t/p,606,1.72,1.15133,1.13961,1.15133,1809.78,42757.29
1993.08.09 09:00,s/l,608,1.86,1.14800,1.14800,1.15949,-857.09,41900.20
1993.08.12 11:00,close,609,1.50,1.13530,1.14149,1.12584,78.60,41978.80
1993.08.16 15:00,t/p,610,2.31,1.14494,1.13588,1.14494,1256.64,43235.44
1993.08.18 15:00,t/p,611,2.13,1.15863,1.14825,1.15863,1621.78,44857.22
1993.08.19 15:00,t/p,612,2.21,1.16556,1.15529,1.16556,1311.86,46169.08
1993.08.31 14:00,s/l,613,2.13,1.16418,1.16418,1.17498,-925.27,45243.81
1993.09.06 13:00,t/p,614,2.11,1.20064,1.18974,1.20064,1652.55,46896.36
1993.09.07 13:00,s/l,615,1.76,1.19817,1.19817,1.21337,134.11,47030.47
1993.09.09 15:00,s/l,616,2.06,1.21014,1.21014,1.22178,-238.96,46791.51
1993.09.13 08:00,s/l,617,1.84,1.21852,1.21852,1.23121,-936.19,45855.32
1993.09.15 16:00,s/l,618,1.81,1.22341,1.22341,1.23688,526.71,46382.03
1993.09.17 13:00,t/p,619,1.64,1.20533,1.21945,1.20533,828.36,47210.39
1993.09.21 17:00,t/p,620,1.84,1.19523,1.20801,1.19523,1411.28,48621.67
1993.09.21 19:00,t/p,621,1.76,1.18457,1.19845,1.18457,1466.08,50087.75
1993.09.22 07:00,s/l,622,1.71,1.19506,1.19506,1.18042,-1005.31,49082.44
1993.09.22 15:00,s/l,623,1.37,1.20041,1.20041,1.18023,-990.37,48092.07
1993.09.24 22:00,s/l,624,1.72,1.19144,1.19144,1.17684,230.65,48322.72
1993.09.30 01:00,s/l,625,1.63,1.19950,1.19950,1.21426,-738.72,47584.01
1993.10.04 02:00,t/p,626,1.75,1.18128,1.19481,1.18128,1414.35,48998.36
1993.10.12 10:00,close,628,1.58,1.21020,1.20216,1.22020,393.74,49392.09
1993.10.12 14:00,t/p,627,2.21,1.21381,1.20229,1.21381,2672.77,52064.87
1993.10.18 01:00,t/p,629,2.39,1.19135,1.20260,1.19135,2392.87,54457.74
1993.10.28 17:00,s/l,630,2.63,1.15753,1.15753,1.14721,-1454.39,53003.35
1993.11.02 19:00,t/p,631,2.66,1.14479,1.15481,1.14479,1567.01,54570.35
1993.11.05 16:00,s/l,632,2.79,1.14890,1.14890,1.13915,-1088.10,53482.25
1993.11.10 04:00,s/l,633,2.75,1.15260,1.15260,1.14286,-1215.22,52267.03
1993.11.15 09:00,s/l,634,3.13,1.15167,1.15167,1.16000,-1042.29,51224.74
1993.11.17 20:00,s/l,635,2.82,1.14638,1.14638,1.13718,-1353.32,49871.42
1993.11.29 17:00,s/l,636,2.94,1.13840,1.13840,1.13066,-158.17,49713.25
1993.12.03 11:00,s/l,637,3.51,1.12763,1.12763,1.12055,-1000.00,48713.25
1993.12.06 15:00,t/p,638,3.46,1.14041,1.13339,1.14041,1456.66,50169.91
1993.12.22 19:00,s/l,639,3.79,1.14764,1.14764,1.15430,-1046.04,49123.87
1993.12.27 15:00,s/l,640,3.83,1.14906,1.14906,1.14266,-980.48,48143.39
1993.12.29 13:00,t/p,641,4.03,1.14192,1.14789,1.14192,1442.74,49586.13
1994.01.03 10:00,s/l,642,3.13,1.12686,1.12686,1.11896,-995.03,48591.10
1994.01.10 11:00,s/l,643,2.94,1.12884,1.12884,1.13724,-313.99,48277.11
1994.01.14 15:00,s/l,644,3.23,1.11944,1.11944,1.11208,13.24,48290.35
1994.01.21 23:00,t/p,645,3.64,1.11841,1.12522,1.11841,2071.16,50361.51
1994.01.25 19:00,s/l,646,2.95,1.12402,1.12402,1.11444,-1132.51,49229.01
1994.01.27 20:00,t/p,647,4.33,1.13303,1.12731,1.13303,1441.89,50670.90
1994.01.28 07:00,s/l,648,4.05,1.13304,1.13304,1.13944,-878.04,49792.86
1994.02.08 15:00,close,650,2.51,1.11570,1.12272,1.11146,748.23,50541.09
1994.02.10 18:00,s/l,649,2.90,1.12272,1.12272,1.11391,-270.86,50270.23
1994.02.14 20:00,t/p,651,3.25,1.13364,1.12591,1.13364,1508.00,51778.23
1994.02.15 09:00,s/l,652,2.32,1.13334,1.13334,1.14583,-1036.58,50741.65
1994.02.24 17:00,s/l,653,2.90,1.13570,1.13570,1.12695,-812.00,49929.65
1994.02.28 08:00,s/l,654,2.49,1.14339,1.14339,1.15341,-1000.48,48929.17
1994.03.11 12:00,close,655,2.25,1.16050,1.15208,1.16445,1595.70,50524.87
1994.03.17 13:00,t/p,656,3.25,1.16106,1.15330,1.16106,1051.70,51576.57
1994.03.25 15:00,t/p,657,3.28,1.17278,1.16465,1.17278,2516.42,54092.99
1994.03.31 14:00,close,658,2.70,1.17290,1.16971,1.18089,-216.00,53876.99
1994.04.04 16:00,t/p,659,2.92,1.15413,1.16342,1.15413,1416.49,55293.48
1994.04.11 00:00,s/l,660,2.98,1.15166,1.15166,1.14201,-22.05,55271.43
1994.04.18 18:00,s/l,661,3.67,1.14702,1.14702,1.13948,-1512.04,53759.39
1994.04.20 12:00,close,662,2.55,1.15680,1.15000,1.16176,660.96,54420.35
1994.04.29 13:00,t/p,663,3.07,1.18717,1.17726,1.18717,1953.13,56373.48
1994.04.29 15:00,s/l,664,3.29,1.18768,1.18768,1.19623,-1125.18,55248.30
1994.05.04 08:00,s/l,665,3.31,1.19446,1.19446,1.20305,-214.49,55033.81
1994.05.04 19:00,s/l,666,2.39,1.18509,1.18509,1.17224,-1097.01,53936.80
1994.05.11 12:00,close,667,2.15,1.16750,1.17861,1.16459,1311.50,55248.30
1994.05.20 12:00,close,668,2.03,1.18940,1.17986,1.19509,830.68,56078.98
1994.05.26 18:00,s/l,669,3.21,1.18762,1.18762,1.19633,-1124.78,54954.19
1994.05.27 15:00,s/l,670,3.12,1.19121,1.19121,1.18243,-1101.05,53853.15
1994.06.15 13:00,t/p,671,3.07,1.19555,1.18567,1.19555,1732.09,55585.24
1994.06.17 09:00,s/l,672,3.49,1.19322,1.19322,1.20117,-1120.99,54464.25
1994.06.20 12:00,t/p,673,3.35,1.21691,1.20889,1.21691,2479.67,56943.92
1994.06.21 13:00,s/l,674,2.63,1.21478,1.21478,1.22688,-1138.26,55805.66
1994.06.22 01:00,s/l,675,2.90,1.22026,1.22026,1.22985,-1115.92,54689.74
1994.06.30 16:00,s/l,676,1.99,1.22709,1.22709,1.21172,-1092.51,53597.23
1994.07.06 04:00,t/p,677,2.42,1.23443,1.22322,1.23443,1844.52,55441.75
1994.07.06 08:00,close,678,1.93,1.23440,1.22718,1.24320,289.50,55731.25
1994.07.06 18:00,s/l,679,2.33,1.23542,1.23542,1.24737,-1113.74,54617.51
1994.07.11 13:00,t/p,680,2.37,1.25702,1.24566,1.25702,2728.34,57345.86
1994.07.12 18:00,s/l,681,2.02,1.27402,1.27402,1.28821,-1147.36,56198.50
1994.07.14 15:00,close,682,1.68,1.25950,1.26896,1.25031,470.40,56668.90
1994.07.19 08:00,s/l,683,1.98,1.25332,1.25332,1.26776,-987.62,55681.27
1994.07.20 16:00,s/l,684,1.88,1.24699,1.24699,1.23201,-791.29,54889.98
1994.07.20 17:00,s/l,685,1.65,1.24835,1.24835,1.22945,-1113.75,53776.23
1994.07.21 18:00,t/p,686,1.66,1.22561,1.24192,1.22561,1708.14,55484.37
1994.07.25 14:00,s/l,688,1.54,1.23028,1.23028,1.20962,-834.37,54650.00
1994.07.27 07:00,s/l,687,1.63,1.23220,1.23220,1.21520,-1120.79,53529.21
1994.07.28 14:00,s/l,689,2.11,1.23574,1.23574,1.24839,-1067.66,52461.55
1994.07.29 14:00,s/l,690,1.96,1.22793,1.22793,1.21410,-264.40,52197.15
1994.07.29 14:00,s/l,691,1.47,1.23038,1.23038,1.21028,-1055.46,51141.69
1994.08.02 14:00,s/l,692,1.88,1.22877,1.22877,1.24235,-1022.34,50119.34
1994.08.05 14:00,s/l,693,1.65,1.23172,1.23172,1.21458,-811.80,49307.54
1994.08.15 17:00,close,695,1.84,1.24690,1.23562,1.25068,1084.13,50391.67
1994.08.16 03:00,close,694,2.26,1.24080,1.23863,1.25006,220.58,50612.25
1994.08.16 16:00,s/l,696,2.43,1.24496,1.24496,1.23455,-1010.88,49601.37
1994.08.26 18:00,t/p,697,2.30,1.23124,1.24267,1.23124,2888.80,52490.17
1994.08.30 17:00,s/l,698,1.69,1.23338,1.23338,1.21608,-1047.63,51442.53
1994.09.02 13:00,s/l,699,2.12,1.23045,1.23045,1.24258,-1029.90,50412.64
1994.09.06 08:00,close,701,1.63,1.25450,1.24308,1.26050,846.30,51258.93
1994.09.07 13:00,s/l,700,1.92,1.25009,1.25009,1.26261,569.47,51828.41
1994.09.09 13:00,s/l,702,2.11,1.24929,1.24929,1.23681,-719.30,51109.11
1994.09.13 14:00,s/l,703,2.29,1.25467,1.25467,1.26625,-468.53,50640.57
1994.09.13 14:00,s/l,704,1.72,1.25212,1.25212,1.26914,-1408.34,49232.24
1994.09.13 17:00,s/l,705,2.27,1.25783,1.25783,1.24700,-914.81,48317.43
1994.09.16 18:00,s/l,706,2.62,1.26249,1.26249,1.27226,128.38,48445.81
1994.09.23 17:00,s/l,707,3.00,1.25758,1.25758,1.26563,-966.00,47479.81
1994.09.27 01:00,s/l,708,2.98,1.25528,1.25528,1.24733,-953.30,46526.51
1994.09.28 13:00,s/l,709,2.92,1.25742,1.25742,1.26538,-930.90,45595.61
1994.10.10 16:00,s/l,710,3.06,1.25663,1.25663,1.24905,-896.58,44699.03
1994.10.14 14:00,t/p,711,2.92,1.27541,1.26773,1.27541,1518.98,46218.01
1994.10.17 17:00,t/p,712,2.71,1.29479,1.28598,1.29479,1298.09,47516.10
1994.10.18 01:00,s/l,713,2.11,1.28910,1.28910,1.30169,-951.19,46564.92
1994.10.21 15:00,s/l,715,2.25,1.29533,1.29533,1.30700,-1208.25,45356.67
1994.10.21 16:00,s/l,714,2.46,1.29460,1.29460,1.30411,-1108.97,44247.70
1994.10.24 16:00,s/l,716,2.36,1.29534,1.29534,1.28599,-887.12,43360.57
1994.10.25 15:00,s/l,717,1.99,1.29625,1.29625,1.30844,-865.65,42494.92
1994.10.28 19:00,s/l,718,2.17,1.28492,1.28492,1.27462,60.76,42555.68
1994.11.02 19:00,t/p,719,1.95,1.27767,1.28855,1.27767,1273.35,43829.03
1994.11.03 17:00,t/p,720,1.87,1.27080,1.28247,1.27080,961.74,44790.77
1994.11.03 17:00,close,721,1.61,1.27240,1.28445,1.26948,1078.70,45869.47
1994.11.03 21:00,s/l,722,1.94,1.27643,1.27643,1.26461,-917.62,44951.85
1994.11.10 22:00,s/l,723,1.86,1.26773,1.26773,1.25516,132.62,45084.47
1994.11.14 10:00,t/p,724,2.08,1.25440,1.26523,1.25440,998.40,46082.87
1994.11.16 17:00,s/l,725,1.94,1.25033,1.25033,1.23825,-727.31,45355.57
1994.12.06 19:00,s/l,726,3.57,1.23034,1.23034,1.22400,-906.78,44448.79
1994.12.19 22:00,s/l,727,3.66,1.22593,1.22593,1.21986,-1328.58,43120.21
1994.12.22 10:00,s/l,728,3.45,1.22260,1.22260,1.21636,-399.17,42721.04
1994.12.28 18:00,t/p,729,3.91,1.22958,1.22412,1.22958,1282.48,44003.52
1994.12.28 19:00,t/p,730,3.61,1.23635,1.23026,1.23635,1317.65,45321.17
1994.12.29 06:00,s/l,731,3.45,1.23620,1.23620,1.24295,-353.28,44967.89
1994.12.29 08:00,s/l,732,2.79,1.23386,1.23386,1.24293,-903.96,44063.93
1995.01.09 16:00,s/l,733,2.61,1.23590,1.23590,1.22715,125.54,44189.47
1995.01.10 21:00,close,734,1.99,1.24960,1.24228,1.25466,577.10,44766.57
1995.01.19 18:00,t/p,735,2.43,1.26332,1.25412,1.26332,1341.36,46107.93
1995.01.20 16:00,close,737,2.03,1.26990,1.26037,1.27305,1015.00,47122.93
1995.01.25 14:00,s/l,736,2.32,1.26950,1.26950,1.27775,990.18,48113.11
1995.01.26 16:00,s/l,738,2.73,1.26572,1.26572,1.25691,-976.52,47136.59
1995.01.31 11:00,s/l,739,2.66,1.26776,1.26776,1.27661,-1209.77,45926.82
1995.02.01 20:00,s/l,740,2.32,1.26054,1.26054,1.25068,-918.49,45008.33
1995.02.08 15:00,close,741,2.68,1.25400,1.25602,1.24723,654.72,45663.06
1995.02.15 08:00,s/l,742,2.62,1.26751,1.26751,1.27523,3524.95,49188.00
1995.02.16 12:00,t/p,743,2.25,1.27577,1.26431,1.27577,1358.55,50546.55
1995.02.16 13:00,t/p,744,3.27,1.27675,1.26917,1.27675,1487.85,52034.40
1995.02.17 09:00,t/p,745,2.29,1.28875,1.27607,1.28875,1864.52,53898.92
1995.02.24 17:00,s/l,746,2.83,1.28590,1.28590,1.27641,-1075.40,52823.52
1995.02.24 19:00,s/l,747,2.41,1.29218,1.29218,1.27992,-1055.58,51767.94
1995.03.02 20:00,s/l,748,2.54,1.30144,1.30144,1.31210,-243.84,51524.10
1995.03.03 09:00,s/l,749,1.98,1.29822,1.29822,1.31272,-1027.22,50496.88
1995.03.03 09:00,s/l,750,2.41,1.29914,1.29914,1.30980,-1028.59,49468.29
1995.03.06 10:00,t/p,751,1.96,1.33126,1.31866,1.33126,913.36,50381.65
1995.03.07 19:00,t/p,752,1.72,1.35397,1.33936,1.35397,1130.04,51511.69
1995.03.07 21:00,s/l,753,1.64,1.34973,1.34973,1.36541,-1028.28,50483.41
1995.03.16 14:00,close,755,1.09,1.33630,1.31953,1.34521,825.78,51309.19
1995.03.16 17:00,s/l,754,1.11,1.32456,1.32456,1.34740,-717.50,50591.69
1995.03.23 13:00,close,756,1.07,1.31910,1.30936,1.33579,32.10,50623.79
1995.03.27 02:00,s/l,757,1.92,1.31277,1.31277,1.29959,-1188.29,49435.50
1995.03.30 13:00,t/p,758,1.87,1.31719,1.33037,1.31719,1479.17,50914.67
1995.03.30 14:00,s/l,759,1.80,1.32043,1.32043,1.30635,-1013.40,49901.27
1995.03.31 08:00,s/l,760,1.77,1.32503,1.32503,1.31095,-999.87,48901.40
1995.04.04 06:00,close,761,1.24,1.34650,1.33767,1.35959,122.02,49023.41
1995.04.10 16:00,t/p,762,1.39,1.32189,1.33940,1.32189,1572.09,50595.50
1995.04.17 12:00,close,763,1.19,1.34310,1.33149,1.35419,402.70,50998.20
1995.04.19 10:00,s/l,765,1.63,1.36154,1.36154,1.37768,-614.18,50384.02
1995.04.19 18:00,s/l,764,1.23,1.34865,1.34865,1.37176,-1015.73,49368.28
1995.04.21 15:00,s/l,766,1.41,1.34005,1.34005,1.32218,-757.03,48611.25
1995.04.24 10:00,s/l,767,1.51,1.35298,1.35298,1.36904,-969.42,47641.83
1995.04.24 15:00,s/l,768,1.14,1.34993,1.34993,1.37365,-965.58,46676.25
1995.04.26 14:00,s/l,769,1.25,1.34725,1.34725,1.32862,-1306.25,45370.00
1995.05.04 13:00,t/p,770,1.39,1.35576,1.33949,1.35576,1324.39,46694.40
1995.05.05 15:00,s/l,771,1.74,1.35479,1.35479,1.36806,-264.13,46430.26
1995.05.09 03:00,s/l,772,1.87,1.35925,1.35925,1.37162,-889.75,45540.52
1995.05.10 22:00,s/l,773,2.05,1.35403,1.35403,1.34295,-908.15,44632.37
1995.05.11 16:00,t/p,774,1.85,1.32320,1.33554,1.32320,1905.50,46537.87
1995.05.12 14:00,close,775,1.17,1.30290,1.31093,1.28872,11.70,46549.57
1995.05.18 17:00,s/l,776,1.24,1.29820,1.29820,1.27944,-930.00,45619.57
1995.05.24 15:00,s/l,777,1.26,1.30172,1.30172,1.28293,-322.31,45297.26
1995.05.25 13:00,t/p,778,1.19,1.31381,1.29480,1.31381,1354.93,46652.19
1995.05.25 14:00,t/p,779,1.11,1.32574,1.30250,1.32574,1658.34,48310.53
1995.05.26 02:00,t/p,780,1.35,1.34471,1.32652,1.34471,1336.77,49647.30
1995.06.01 08:00,t/p,781,1.41,1.31918,1.33688,1.31918,1277.88,50925.19
1995.06.01 16:00,s/l,782,1.13,1.32634,1.32634,1.30130,-1010.22,49914.97
1995.06.09 10:00,s/l,783,1.32,1.33614,1.33614,1.31730,-1005.31,48909.65
1995.06.22 16:00,s/l,784,2.09,1.35035,1.35035,1.36222,-558.87,48350.79
1995.06.23 10:00,s/l,785,1.99,1.34776,1.34776,1.33562,-970.92,47379.87
1995.06.26 15:00,s/l,786,1.66,1.34722,1.34722,1.36312,-942.88,46436.99
1995.07.07 05:00,s/l,787,1.93,1.35518,1.35518,1.36647,273.29,46710.28
1995.07.13 12:00,s/l,788,2.65,1.34202,1.34202,1.33323,-932.80,45777.48
1995.07.17 05:00,s/l,789,2.43,1.35048,1.35048,1.36054,-348.95,45428.53
1995.07.19 01:00,close,790,1.67,1.35630,1.35166,1.36689,-134.94,45293.59
1995.07.20 17:00,s/l,791,1.97,1.36292,1.36292,1.37437,-1044.89,44248.70
1995.07.26 13:00,s/l,792,2.19,1.35890,1.35890,1.34864,-617.36,43631.34
1995.07.27 23:00,s/l,793,2.02,1.36541,1.36541,1.37489,239.57,43870.91
1995.08.02 02:00,s/l,794,2.20,1.37263,1.37263,1.38281,-523.16,43347.75
1995.08.02 03:00,s/l,795,1.67,1.37036,1.37036,1.38503,-876.42,42471.34
1995.08.03 07:00,s/l,796,1.45,1.36324,1.36324,1.34689,-855.06,41616.27
1995.08.10 13:00,t/p,797,1.68,1.34391,1.35623,1.34391,1225.56,42841.83
1995.08.10 20:00,s/l,798,1.86,1.34177,1.34177,1.32984,-87.42,42754.41
1995.08.15 13:00,t/p,799,1.77,1.30926,1.32166,1.30926,1936.38,44690.79
1995.08.16 09:00,s/l,801,1.35,1.29659,1.29659,1.27786,-903.15,43787.64
1995.08.17 19:00,s/l,800,1.52,1.29993,1.29993,1.28486,-943.31,42844.33
1995.08.24 13:00,s/l,802,1.43,1.28838,1.28838,1.27344,-855.14,41989.19
1995.08.30 12:00,close,803,1.27,1.29070,1.29597,1.27757,-165.10,41824.09
1995.09.11 13:00,s/l,804,2.29,1.29725,1.29725,1.30637,-835.85,40988.24
1995.09.15 14:00,s/l,805,1.98,1.28324,1.28324,1.27289,-819.72,40168.52
1995.09.21 07:00,t/p,806,1.47,1.31170,1.29645,1.31170,1437.07,41605.59
1995.09.21 17:00,t/p,807,1.46,1.32422,1.30832,1.32422,1492.12,43097.71
1995.09.25 01:00,s/l,808,1.38,1.32470,1.32470,1.34207,-856.70,42241.01
1995.10.02 18:00,close,809,1.25,1.32740,1.33241,1.31362,-212.50,42028.51
1995.10.04 16:00,s/l,810,1.41,1.32527,1.32527,1.31035,-872.65,41155.86
1995.10.06 04:00,s/l,811,1.80,1.32805,1.32805,1.33942,-550.44,40605.42
1995.10.18 13:00,s/l,812,1.97,1.33303,1.33303,1.34345,-448.77,40156.65
1995.10.23 09:00,s/l,813,1.83,1.35063,1.35063,1.36155,-799.71,39356.94
1995.10.25 13:00,s/l,814,1.37,1.34536,1.34536,1.36143,-788.57,38568.37
1995.10.26 15:00,s/l,815,1.73,1.34724,1.34724,1.33614,-768.12,37800.25
1995.10.26 16:00,s/l,816,1.64,1.34301,1.34301,1.33149,-756.04,37044.21
1995.11.01 15:00,t/p,817,1.56,1.33818,1.35005,1.33818,1104.79,38149.00
1995.11.09 22:00,s/l,818,2.08,1.34352,1.34352,1.35297,-183.04,37965.96
1995.11.14 01:00,s/l,819,2.09,1.34052,1.34052,1.33148,-760.55,37205.41
1995.11.16 16:00,s/l,820,1.47,1.34654,1.34654,1.36071,-747.35,36458.07
1995.11.20 13:00,s/l,821,1.98,1.34267,1.34267,1.33350,-607.86,35850.21
1995.11.28 17:00,s/l,822,1.62,1.33261,1.33261,1.32027,-714.42,35135.79
1995.12.01 18:00,s/l,823,1.88,1.32054,1.32054,1.31093,-255.49,34880.29
1995.12.04 11:00,s/l,824,1.92,1.32124,1.32124,1.33040,-357.12,34523.17
1995.12.07 12:00,s/l,825,1.52,1.32463,1.32463,1.31195,-697.22,33825.95
1995.12.14 12:00,s/l,826,1.85,1.31924,1.31924,1.31014,-687.46,33138.49
1995.12.18 15:00,t/p,827,1.94,1.32690,1.31840,1.32690,986.30,34124.79
1995.12.21 02:00,s/l,828,1.99,1.32447,1.32447,1.33304,-687.35,33437.44
1996.01.04 20:00,s/l,829,1.88,1.32068,1.32068,1.31174,-541.44,32896.00
1996.01.12 17:00,s/l,830,1.77,1.33052,1.33052,1.32122,-484.80,32411.20
1996.01.16 22:00,t/p,831,1.47,1.31029,1.32259,1.31029,1162.77,33573.97
1996.01.25 16:00,s/l,832,1.92,1.29662,1.29662,1.30533,-668.16,32905.81
1996.02.05 17:00,t/p,833,1.99,1.30678,1.29831,1.30678,1468.62,34374.43
1996.02.06 17:00,s/l,834,1.42,1.30369,1.30369,1.31716,-684.16,33690.27
1996.02.09 15:00,s/l,835,1.92,1.30120,1.30120,1.30995,-672.00,33018.27
1996.02.16 15:00,s/l,836,2.16,1.30906,1.30906,1.31667,-656.64,32361.63
1996.02.16 20:00,t/p,837,2.12,1.31447,1.30686,1.31447,968.84,33330.47
1996.02.20 03:00,s/l,838,1.62,1.31709,1.31709,1.32860,-667.12,32663.35
1996.02.29 21:00,close,839,1.60,1.30650,1.31536,1.30399,768.00,33431.35
1996.03.08 09:00,s/l,840,1.49,1.30031,1.30031,1.31288,-670.20,32761.15
1996.03.08 21:00,s/l,841,1.87,1.29771,1.29771,1.28893,-357.17,32403.98
1996.03.11 09:00,close,842,1.46,1.29750,1.30112,1.28875,-116.80,32287.18
1996.03.13 18:00,s/l,843,1.68,1.30377,1.30377,1.31334,-644.78,31642.40
1996.03.28 19:00,t/p,844,2.33,1.30586,1.29892,1.30586,1248.88,32891.28
1996.03.29 11:00,close,845,1.92,1.30430,1.30168,1.31125,-153.60,32737.68
1996.04.03 13:00,s/l,846,2.36,1.30377,1.30377,1.29684,-662.69,32074.99
1996.04.08 05:00,s/l,847,2.48,1.30298,1.30298,1.29652,-644.55,31430.44
1996.04.10 17:00,close,848,1.72,1.28600,1.29204,1.28185,412.80,31843.24
1996.04.17 15:00,s/l,849,2.23,1.28464,1.28464,1.27753,-641.79,31201.44
1996.04.22 00:00,t/p,850,1.90,1.27809,1.28628,1.27809,929.29,32130.73
1996.04.22 14:00,s/l,851,2.07,1.28233,1.28233,1.27450,-627.21,31503.52
1996.04.26 18:00,s/l,852,2.25,1.27241,1.27241,1.27939,-627.75,30875.77
1996.05.07 11:00,s/l,853,2.22,1.27482,1.27482,1.28176,-617.16,30258.61
1996.05.14 12:00,close,854,1.67,1.26880,1.27470,1.26461,247.33,30505.94
1996.05.28 08:00,t/p,855,2.31,1.26010,1.26693,1.26010,1378.38,31884.32
1996.05.29 19:00,t/p,856,2.67,1.26968,1.26372,1.26968,955.86,32840.18
1996.05.30 10:00,t/p,857,2.60,1.27178,1.26548,1.27178,586.56,33426.74
1996.06.03 12:00,s/l,858,2.59,1.27483,1.27483,1.28151,-72.00,33354.74
1996.06.14 12:00,t/p,859,2.50,1.27755,1.27080,1.27755,1210.50,34565.24
1996.06.14 14:00,s/l,860,2.03,1.27520,1.27520,1.28471,-690.20,33875.04
1996.06.18 15:00,s/l,861,2.57,1.28217,1.28217,1.28875,-675.91,33199.13
1996.06.25 22:00,s/l,862,2.01,1.27640,1.27640,1.26717,-667.12,32532.01
1996.07.04 16:00,s/l,863,1.98,1.27922,1.27922,1.28840,-649.44,31882.57
1996.07.11 02:00,s/l,864,3.22,1.27718,1.27718,1.27224,-655.91,31226.65
1996.07.12 15:00,s/l,865,2.90,1.27869,1.27869,1.28421,-527.22,30699.43
1996.07.15 15:00,s/l,866,2.84,1.28126,1.28126,1.27586,-613.44,30085.99
1996.07.17 00:00,s/l,867,1.50,1.30621,1.30621,1.31739,-599.70,29486.29
1996.07.24 08:00,s/l,868,1.37,1.30859,1.30859,1.29786,-535.53,28950.76
1996.07.26 11:00,s/l,869,1.22,1.30898,1.30898,1.32079,-759.82,28190.94
1996.07.30 17:00,s/l,870,1.17,1.31154,1.31154,1.29945,-523.93,27667.02
1996.08.13 21:00,s/l,871,2.21,1.30940,1.30940,1.31564,-552.50,27114.52
1996.08.15 06:00,close,872,1.58,1.30230,1.30713,1.29753,212.19,27326.71
1996.08.23 01:00,s/l,873,2.23,1.30213,1.30213,1.29581,-256.23,27070.49
1996.08.26 16:00,s/l,874,1.91,1.30978,1.30978,1.31633,-330.05,26740.44
1996.08.28 01:00,s/l,875,1.73,1.30867,1.30867,1.31743,-492.36,26248.08
1996.09.05 15:00,s/l,876,1.96,1.30559,1.30559,1.31236,-692.66,25555.42
1996.09.09 14:00,s/l,877,2.26,1.30412,1.30412,1.29833,-460.81,25094.60
1996.09.10 17:00,t/p,878,1.48,1.28732,1.29678,1.28732,899.84,25994.44
1996.09.19 13:00,s/l,879,1.88,1.28707,1.28707,1.29415,-423.75,25570.69
1996.09.20 06:00,s/l,880,1.82,1.28850,1.28850,1.28149,-513.06,25057.63
1996.09.25 03:00,s/l,881,1.93,1.29448,1.29448,1.30102,-584.40,24473.23
1996.09.26 12:00,t/p,882,1.38,1.28172,1.29164,1.28172,880.44,25353.67
1996.09.30 21:00,s/l,883,1.83,1.28132,1.28132,1.27427,-442.86,24910.81
1996.10.03 15:00,s/l,884,1.80,1.27797,1.27797,1.27104,-382.86,24527.95
1996.10.15 15:00,t/p,885,2.36,1.26862,1.27392,1.26862,703.28,25231.23
1996.10.17 13:00,close,886,1.69,1.26870,1.27297,1.26465,206.86,25438.08
1996.10.23 03:00,s/l,887,2.00,1.27845,1.27845,1.28482,-491.60,24946.48
1996.11.01 03:00,t/p,888,1.64,1.28265,1.29023,1.28265,743.08,25689.57
1996.11.01 12:00,s/l,889,1.44,1.28707,1.28707,1.27708,-514.08,25175.49
1996.11.07 16:00,s/l,890,1.24,1.29076,1.29076,1.30208,-500.96,24674.53
1996.11.14 14:00,close,891,1.11,1.29340,1.29802,1.28564,13.76,24688.29
1996.11.19 17:00,s/l,892,1.30,1.29612,1.29612,1.30557,-492.44,24195.85
1996.11.20 17:00,t/p,893,1.42,1.30628,1.29781,1.30628,721.36,24917.21
1996.11.22 14:00,s/l,894,1.14,1.29896,1.29896,1.31112,-498.41,24418.80
1996.11.26 18:00,close,895,1.08,1.28130,1.28843,1.27519,991.55,25410.35
1996.11.29 22:00,t/p,896,1.47,1.27073,1.27934,1.27073,624.90,26035.25
1996.12.03 02:00,t/p,897,1.40,1.25323,1.26252,1.25323,777.14,26812.39
1996.12.10 07:00,close,898,1.03,1.25930,1.26487,1.25039,39.24,26851.63
1996.12.27 16:00,s/l,899,1.82,1.26124,1.26124,1.25390,-535.08,26316.55
1996.12.31 16:00,t/p,900,1.98,1.27318,1.26654,1.27318,788.04,27104.59
1997.01.02 01:00,s/l,901,1.91,1.27054,1.27054,1.27770,-227.67,26876.92
1997.01.07 03:00,s/l,902,1.26,1.25706,1.25706,1.24513,-539.15,26337.77
1997.01.14 15:00,t/p,903,1.34,1.23494,1.24470,1.23494,833.75,27171.51
1997.01.23 19:00,close,904,1.02,1.19560,1.20562,1.19072,473.59,27645.10
1997.02.10 00:00,s/l,905,1.12,1.18623,1.18623,1.17243,-554.29,27090.81
1997.02.12 02:00,t/p,906,1.07,1.16745,1.18153,1.16745,966.32,28057.13
1997.02.17 23:00,t/p,907,1.50,1.15110,1.16043,1.15110,840.00,28897.13
1997.02.19 12:00,s/l,908,1.39,1.15466,1.15466,1.16500,-576.57,28320.56
1997.02.26 16:00,s/l,909,1.35,1.16250,1.16250,1.17299,-596.16,27724.40
1997.02.27 20:00,s/l,910,1.33,1.16111,1.16111,1.15059,-368.01,27356.39
1997.02.28 18:00,s/l,911,1.35,1.15812,1.15812,1.14782,-461.70,26894.69
1997.03.12 05:00,s/l,912,1.25,1.14461,1.14461,1.15663,-538.25,26356.44
1997.03.13 14:00,s/l,913,1.25,1.14980,1.14980,1.16157,-525.00,25831.44
1997.03.18 14:00,t/p,914,1.48,1.15929,1.15048,1.15929,854.55,26685.99
1997.03.19 09:00,s/l,915,1.14,1.16035,1.16035,1.17336,-531.01,26154.98
1997.03.26 04:00,s/l,916,1.35,1.15837,1.15837,1.14870,-525.02,25629.96
1997.03.31 17:00,s/l,917,1.34,1.17230,1.17230,1.18181,-509.20,25120.76
1997.04.08 12:00,close,918,1.06,1.14410,1.14984,1.13657,106.00,25226.76
1997.04.22 09:00,s/l,919,1.67,1.14679,1.14679,1.15431,-504.01,24722.75
1997.04.22 09:00,s/l,920,1.13,1.14458,1.14458,1.15695,-500.36,24222.39
1997.04.24 08:00,close,921,1.10,1.13900,1.14430,1.13198,90.64,24313.03
1997.04.28 00:00,t/p,922,1.59,1.12937,1.13725,1.12937,908.05,25221.08
1997.04.28 08:00,s/l,923,1.65,1.13185,1.13185,1.12422,-503.25,24717.83
1997.05.06 14:00,s/l,924,1.53,1.13523,1.13523,1.12716,-500.00,24217.83
1997.05.13 09:00,s/l,925,1.09,1.15254,1.15254,1.14011,-483.96,23733.87
1997.05.26 07:00,s/l,926,1.00,1.16048,1.16048,1.17229,-472.00,23261.87
1997.06.02 14:00,t/p,927,1.04,1.13262,1.14376,1.13262,694.72,23956.59
1997.06.10 14:00,s/l,928,0.87,1.14003,1.14003,1.15534,-476.59,23480.00
1997.06.16 10:00,s/l,929,1.29,1.13106,1.13106,1.12192,-461.69,23018.31
1997.06.24 09:00,s/l,930,1.11,1.13735,1.13735,1.14896,-460.65,22557.66
1997.06.30 22:00,close,931,1.16,1.12590,1.13000,1.11880,522.00,23079.66
1997.07.10 16:00,s/l,932,1.51,1.11906,1.11906,1.12666,-459.04,22620.62
1997.07.14 10:00,t/p,933,1.16,1.09789,1.10880,1.09789,813.16,23433.78
1997.07.22 16:00,t/p,934,1.21,1.08237,1.09209,1.08237,923.23,24357.01
1997.07.24 12:00,t/p,935,1.03,1.07164,1.08465,1.07164,1059.25,25416.26
1997.07.24 15:00,s/l,936,1.16,1.07365,1.07365,1.06277,-504.60,24911.66
1997.07.29 01:00,s/l,937,1.41,1.06894,1.06894,1.06008,-473.62,24438.04
1997.08.05 10:00,t/p,938,1.09,1.04567,1.05816,1.04567,873.20,25311.24
1997.08.06 14:00,s/l,939,1.39,1.04190,1.04190,1.03290,150.26,25461.50
1997.08.08 16:00,t/p,940,1.26,1.06578,1.05564,1.06578,892.08,26353.58
1997.08.11 01:00,s/l,941,1.21,1.05897,1.05897,1.06979,-524.90,25828.68
1997.08.13 15:00,t/p,942,0.98,1.07141,1.05677,1.07141,922.18,26750.86
1997.08.14 07:00,s/l,943,1.01,1.06544,1.06544,1.08017,-531.26,26219.60
1997.08.15 05:00,s/l,944,1.02,1.06789,1.06789,1.05516,-521.12,25698.48
1997.08.18 20:00,s/l,945,1.00,1.07429,1.07429,1.08706,-301.80,25396.68
1997.08.20 01:00,close,946,0.85,1.06550,1.07585,1.05918,372.38,25769.07
1997.08.22 11:00,t/p,947,0.86,1.08076,1.06402,1.08076,925.36,26694.43
1997.08.22 15:00,s/l,948,1.03,1.07804,1.07804,1.09094,-531.48,26162.95
1997.08.25 08:00,s/l,949,0.82,1.07584,1.07584,1.09393,-530.38,25632.57
1997.08.27 12:00,s/l,950,0.95,1.08662,1.08662,1.10031,-274.36,25358.21
1997.09.02 15:00,t/p,951,0.92,1.07677,1.09049,1.07677,753.66,26111.88
1997.09.08 14:00,s/l,952,1.05,1.08679,1.08679,1.09957,-85.89,26025.99
1997.09.11 06:00,t/p,953,1.10,1.09786,1.08609,1.09786,773.96,26799.95
1997.09.11 15:00,close,954,0.82,1.09670,1.08604,1.10384,350.63,27150.58
1997.09.15 02:00,s/l,955,1.20,1.10429,1.10429,1.11557,-542.16,26608.42
1997.09.18 15:00,s/l,956,1.24,1.10893,1.10893,1.11961,-628.68,25979.74
1997.09.25 18:00,close,957,0.91,1.11370,1.10329,1.11843,589.32,26569.05
1997.09.30 17:00,s/l,958,1.23,1.11339,1.11339,1.10266,-527.67,26041.38
1997.10.02 12:00,s/l,959,0.96,1.11110,1.11110,1.09597,-518.40,25522.98
1997.10.06 14:00,s/l,961,0.99,1.11347,1.11347,1.12811,-517.77,25005.21
1997.10.06 15:00,s/l,960,1.12,1.11194,1.11194,1.12360,-153.22,24852.00
1997.10.09 16:00,s/l,962,1.21,1.12392,1.12392,1.13411,-493.68,24358.32
1997.10.14 09:00,s/l,963,1.21,1.12380,1.12380,1.11380,-488.60,23869.72
1997.10.17 06:00,t/p,964,1.52,1.11588,1.12374,1.11588,732.64,24602.36
1997.10.20 11:00,t/p,965,1.07,1.10696,1.11978,1.10696,879.65,25482.01
1997.10.22 15:00,s/l,966,1.04,1.10335,1.10335,1.09090,-485.58,24996.43
1997.10.24 10:00,s/l,967,1.39,1.10546,1.10546,1.11457,-201.27,24795.16
1997.10.28 08:00,s/l,968,0.91,1.13018,1.13018,1.14536,-493.22,24301.94
1997.10.28 18:00,s/l,969,0.85,1.13189,1.13189,1.14787,-485.35,23816.59
1997.11.06 00:00,close,970,0.79,1.14300,1.13293,1.14992,258.17,24074.76
1997.11.12 20:00,s/l,971,1.03,1.14301,1.14301,1.13124,-330.63,23744.13
1997.11.21 20:00,s/l,972,0.96,1.12971,1.12971,1.11596,-471.36,23272.77
1997.12.02 12:00,s/l,973,1.47,1.10866,1.10866,1.10075,-467.31,22805.46
1997.12.08 20:00,close,975,1.18,1.09770,1.10423,1.09350,318.60,23124.06
1997.12.09 05:00,t/p,974,1.43,1.09662,1.10459,1.09662,549.41,23673.46
1997.12.11 14:00,s/l,976,1.57,1.10390,1.10390,1.11141,-471.00,23202.46
1997.12.12 07:00,s/l,977,1.16,1.11153,1.11153,1.12265,-461.45,22741.02
1997.12.15 16:00,s/l,978,1.08,1.10821,1.10821,1.09642,-454.68,22286.34
1997.12.17 19:00,s/l,979,1.03,1.10660,1.10660,1.11863,-442.90,21843.44
1997.12.29 16:00,s/l,980,1.24,1.10107,1.10107,1.10989,-431.27,21412.16
1997.12.31 14:00,close,981,1.06,1.09160,1.10113,1.08985,580.99,21993.15
1998.01.06 14:00,s/l,982,1.07,1.07670,1.07670,1.06522,-438.70,21554.45
1998.01.16 16:00,s/l,983,1.08,1.07447,1.07447,1.06455,-430.81,21123.64
1998.01.16 16:00,s/l,984,0.95,1.07411,1.07411,1.06148,-428.45,20695.19
1998.01.23 04:00,close,985,0.87,1.08830,1.08008,1.09330,303.80,20998.99
1998.01.23 12:00,s/l,986,1.22,1.09076,1.09076,1.09935,-419.68,20579.31
1998.01.26 08:00,s/l,987,1.06,1.10923,1.10923,1.11891,-410.22,20169.09
1998.01.26 09:00,s/l,988,0.81,1.10679,1.10679,1.12082,-405.81,19763.28
1998.01.28 19:00,t/p,989,0.85,1.08044,1.09204,1.08044,472.60,20235.88
1998.01.29 15:00,close,990,0.76,1.07580,1.08799,1.07318,524.40,20760.28
1998.01.30 14:00,s/l,992,0.76,1.07578,1.07578,1.06044,-416.48,20343.80
1998.02.02 10:00,t/p,991,0.83,1.06675,1.07917,1.06675,615.20,20959.00
1998.02.04 10:00,close,993,0.73,1.07800,1.07233,1.08821,-0.58,20958.41
1998.02.10 04:00,close,994,0.66,1.07990,1.08404,1.06628,-146.45,20811.96
1998.02.16 12:00,close,995,0.69,1.07630,1.08191,1.06508,-28.91,20783.05
1998.02.24 01:00,s/l,996,1.12,1.08906,1.08906,1.09867,173.82,20956.87
1998.02.24 09:00,s/l,997,0.84,1.08787,1.08787,1.10195,-423.19,20533.68
1998.02.27 11:00,s/l,998,0.87,1.08311,1.08311,1.06992,-411.42,20122.26
1998.03.10 11:00,close,999,0.89,1.06980,1.07478,1.06224,41.12,20163.38
1998.03.13 16:00,s/l,1000,1.34,1.07140,1.07140,1.06391,-402.00,19761.38
1998.03.16 03:00,s/l,1001,1.22,1.07598,1.07598,1.08403,-332.82,19428.56
1998.03.25 16:00,s/l,1002,1.60,1.07263,1.07263,1.06656,-468.80,18959.76
1998.03.27 14:00,s/l,1003,1.54,1.07362,1.07362,1.07982,-182.95,18776.81
1998.03.30 11:00,t/p,1004,1.64,1.06797,1.07369,1.06797,559.40,19336.21
1998.04.01 16:00,close,1005,1.17,1.05660,1.06428,1.05509,510.35,19846.57
1998.04.07 01:00,t/p,1006,1.59,1.06663,1.06042,1.06663,591.80,20438.36
1998.04.09 08:00,s/l,1007,1.22,1.07505,1.07505,1.08443,-408.70,20029.66
1998.04.15 15:00,t/p,1008,1.27,1.09016,1.08222,1.09016,628.90,20658.57
1998.04.16 07:00,s/l,1009,1.05,1.08306,1.08306,1.09382,-405.72,20252.85
1998.04.23 09:00,close,1010,1.03,1.09340,1.08858,1.09955,89.40,20342.25
1998.04.24 08:00,s/l,1011,1.23,1.09040,1.09040,1.08216,-408.24,19934.02
1998.05.01 20:00,s/l,1012,1.24,1.09832,1.09832,1.10652,-319.92,19614.10
1998.05.04 03:00,s/l,1013,0.95,1.09587,1.09587,1.10743,-393.11,19220.99
1998.05.18 03:00,s/l,1014,1.36,1.09976,1.09976,1.09260,-473.14,18747.84
1998.05.21 13:00,t/p,1015,1.03,1.11231,1.10218,1.11231,668.06,19415.90
1998.05.25 09:00,s/l,1016,1.01,1.11028,1.11028,1.12097,-427.84,18988.06
1998.06.04 15:00,close,1017,1.05,1.11060,1.10350,1.11358,364.98,19353.04
1998.06.11 14:00,t/p,1018,1.40,1.08603,1.09314,1.08603,771.82,20124.86
1998.06.11 14:00,close,1019,1.07,1.08680,1.09393,1.08377,374.50,20499.36
1998.06.12 02:00,t/p,1020,1.47,1.08185,1.08894,1.08185,695.46,21194.82
1998.06.12 15:00,s/l,1021,1.09,1.08746,1.08746,1.07693,-411.91,20782.91
1998.06.18 16:00,s/l,1022,1.30,1.09302,1.09302,1.10098,-416.52,20366.39
1998.06.19 00:00,s/l,1023,1.24,1.09385,1.09385,1.08548,-120.16,20246.23
1998.06.22 01:00,s/l,1024,1.20,1.09414,1.09414,1.10255,-596.16,19650.07
1998.06.25 03:00,s/l,1025,1.05,1.09022,1.09022,1.08093,-398.58,19251.49
1998.06.26 22:00,s/l,1026,1.17,1.08357,1.08357,1.07489,237.51,19489.00
1998.07.02 13:00,t/p,1027,1.25,1.07457,1.08246,1.07457,546.63,20035.63
1998.07.14 03:00,close,1028,1.06,1.08790,1.08004,1.09057,433.75,20469.38
1998.07.17 02:00,close,1029,1.07,1.09680,1.09028,1.10097,288.04,20757.42
1998.07.20 07:00,s/l,1030,1.45,1.09894,1.09894,1.10609,-414.70,20342.72
1998.07.29 12:00,s/l,1031,1.48,1.10414,1.10414,1.11129,-69.26,20273.46
1998.08.03 16:00,s/l,1032,1.36,1.09887,1.09887,1.09144,-403.92,19869.54
1998.08.06 09:00,t/p,1033,1.25,1.10975,1.10184,1.10975,589.75,20459.29
1998.08.10 20:00,s/l,1034,1.24,1.10319,1.10319,1.09497,-410.32,20048.97
1998.08.17 07:00,t/p,1035,1.21,1.08204,1.09030,1.08204,597.86,20646.84
1998.08.17 10:00,s/l,1036,0.97,1.08844,1.08844,1.07657,-3.88,20642.96
1998.08.27 16:00,s/l,1037,1.37,1.08559,1.08559,1.07811,-409.63,20233.33
1998.08.28 09:00,t/p,1038,1.29,1.09511,1.08709,1.09511,851.66,21084.98
1998.08.31 10:00,s/l,1039,0.90,1.10525,1.10525,1.11828,-418.50,20666.48
1998.09.08 01:00,s/l,1040,0.76,1.13266,1.13266,1.14789,-414.05,20252.44
1998.09.10 14:00,t/p,1041,0.67,1.15879,1.14201,1.15879,890.43,21142.87
1998.09.14 00:00,s/l,1042,0.65,1.15402,1.15402,1.17217,-422.24,20720.63
1998.10.02 09:00,t/p,1043,0.96,1.19295,1.18204,1.19295,781.63,21502.26
1998.10.02 16:00,s/l,1044,0.88,1.19435,1.19435,1.20648,-409.20,21093.06
1998.10.08 10:00,s/l,1045,0.73,1.22443,1.22443,1.23886,-421.21,20671.85
1998.10.13 08:00,s/l,1046,0.63,1.19408,1.19408,1.17762,-611.04,20060.81
1998.10.13 12:00,s/l,1047,0.58,1.18944,1.18944,1.20658,-397.88,19662.93
1998.10.22 15:00,s/l,1048,0.63,1.19367,1.19367,1.17824,-392.30,19270.63
1998.11.06 17:00,s/l,1049,1.04,1.17342,1.17342,1.18262,-383.55,18887.08
1998.11.09 16:00,t/p,1050,1.02,1.16298,1.17135,1.16298,1009.90,19896.98
1998.11.17 09:00,close,1051,0.82,1.17740,1.16679,1.18026,474.94,20371.92
1998.11.23 08:00,t/p,1052,0.99,1.15330,1.16380,1.15330,897.14,21269.06
1998.11.24 12:00,close,1054,0.82,1.14440,1.15303,1.13867,285.44,21554.50
1998.11.25 10:00,s/l,1053,1.11,1.15153,1.15153,1.14195,-429.35,21125.16
1998.11.30 10:00,s/l,1055,1.19,1.14584,1.14584,1.13700,-447.32,20677.83
1998.12.11 07:00,t/p,1056,1.03,1.18538,1.17524,1.18538,707.82,21385.65
1998.12.14 04:00,close,1057,0.91,1.18910,1.17955,1.19258,445.17,21830.82
1998.12.14 10:00,s/l,1058,1.20,1.18565,1.18565,1.19478,-378.00,21452.82
1998.12.31 12:00,s/l,1059,1.10,1.16968,1.16968,1.15998,-400.07,21052.75
1999.01.04 09:00,s/l,1060,1.15,1.18126,1.18126,1.19036,-418.60,20634.15
1999.01.06 18:00,t/p,1061,1.07,1.15775,1.16734,1.15775,615.25,21249.40
1999.01.07 03:00,s/l,1062,1.03,1.16391,1.16391,1.15364,-254.10,20995.30
1999.01.12 01:00,t/p,1063,0.76,1.14752,1.16289,1.14752,747.99,21743.29
1999.01.13 10:00,t/p,1064,0.81,1.16545,1.15059,1.16545,772.90,22516.20
1999.01.13 17:00,s/l,1066,0.74,1.16721,1.16721,1.18426,-450.66,22065.54
1999.01.13 19:00,s/l,1065,0.80,1.16494,1.16494,1.17884,-444.80,21620.74
1999.01.27 17:00,t/p,1067,1.31,1.14787,1.15608,1.14787,645.83,22266.57
1999.01.29 02:00,close,1068,0.77,1.14030,1.14876,1.13263,202.05,22468.61
1999.02.12 16:00,s/l,1069,1.20,1.12676,1.12676,1.11735,-429.48,22039.13
1999.02.12 16:00,s/l,1070,0.99,1.12791,1.12791,1.11528,-446.49,21592.64
1999.02.17 12:00,s/l,1071,0.91,1.12521,1.12521,1.11202,-430.34,21162.30
1999.02.22 02:00,t/p,1072,1.15,1.10187,1.11126,1.10187,829.27,21991.57
1999.02.23 08:00,s/l,1073,0.92,1.10664,1.10664,1.09337,-437.83,21553.74
1999.02.26 10:00,s/l,1074,1.07,1.10173,1.10173,1.09166,-431.21,21122.53
1999.03.02 15:00,s/l,1075,0.85,1.09187,1.09187,1.07796,-252.45,20870.08
1999.03.11 09:00,s/l,1076,1.12,1.09131,1.09131,1.10078,-270.37,20599.71
1999.03.11 15:00,t/p,1077,1.06,1.08440,1.09406,1.08440,540.60,21140.31
1999.03.16 14:00,s/l,1078,0.96,1.08878,1.08878,1.07783,-420.48,20719.83
1999.03.16 14:00,s/l,1079,0.76,1.09054,1.09054,1.07503,-421.04,20298.79
1999.03.26 21:00,s/l,1080,0.95,1.07723,1.07723,1.06640,-221.35,20077.44
1999.03.31 20:00,s/l,1081,0.98,1.07683,1.07683,1.08700,-398.86,19678.58
1999.04.06 16:00,t/p,1082,1.02,1.08206,1.07246,1.08206,587.52,20266.10
1999.04.07 07:00,s/l,1083,0.99,1.07970,1.07970,1.08996,-396.79,19869.31
1999.04.07 07:00,s/l,1084,0.81,1.07880,1.07880,1.09280,-405.65,19463.66
1999.04.16 02:00,t/p,1085,1.01,1.06578,1.07564,1.06578,616.20,20079.86
1999.04.16 15:00,s/l,1086,0.75,1.07088,1.07088,1.05722,105.08,20184.94
1999.04.30 13:00,t/p,1087,1.12,1.05620,1.06520,1.05620,585.09,20770.03
1999.05.06 09:00,t/p,1088,1.21,1.08184,1.07328,1.08184,619.04,21389.06
1999.05.06 09:00,t/p,1089,0.92,1.08250,1.07005,1.08250,733.79,22122.86
1999.05.10 15:00,s/l,1090,1.32,1.07554,1.07554,1.06718,-454.08,21668.78
1999.05.12 14:00,s/l,1091,1.22,1.06883,1.06883,1.06001,-430.66,21238.12
1999.06.02 12:00,s/l,1092,1.10,1.03953,1.03953,1.02996,-322.30,20915.82
1999.06.08 19:00,t/p,1093,0.98,1.04551,1.03432,1.04551,1069.18,21985.00
1999.06.18 12:00,s/l,1094,0.83,1.03619,1.03619,1.02138,-453.68,21531.32
1999.06.18 16:00,s/l,1095,1.01,1.03734,1.03734,1.04798,-430.26,21101.06
1999.06.25 15:00,close,1096,0.84,1.04630,1.04108,1.05514,16.80,21117.86
1999.06.30 07:00,close,1097,0.93,1.03300,1.03803,1.02535,42.97,21160.82
1999.07.15 21:00,s/l,1098,1.20,1.01809,1.01809,1.02686,-424.08,20736.74
1999.07.19 15:00,s/l,1099,1.30,1.01637,1.01637,1.00844,-438.10,20298.64
1999.07.20 09:00,t/p,1100,0.93,1.03719,1.02507,1.03719,724.47,21023.11
1999.07.21 09:00,close,1101,0.88,1.04660,1.03564,1.04896,544.90,21568.01
1999.07.26 16:00,s/l,1102,0.93,1.06467,1.06467,1.07675,155.31,21723.32
1999.08.17 09:00,t/p,1103,1.26,1.05185,1.06044,1.05185,644.11,22367.43
1999.08.18 14:00,s/l,1104,1.32,1.05508,1.05508,1.04662,-448.67,21918.76
1999.08.19 09:00,s/l,1105,1.37,1.05018,1.05018,1.04222,-435.66,21483.10
1999.08.23 13:00,s/l,1106,1.24,1.06051,1.06051,1.06948,11.66,21494.76
1999.08.24 11:00,s/l,1107,0.85,1.05211,1.05211,1.03809,-425.85,21068.91
1999.08.30 22:00,s/l,1108,0.92,1.04904,1.04904,1.03745,-417.22,20651.69
1999.09.01 13:00,s/l,1110,0.89,1.05851,1.05851,1.07023,-417.41,20234.28
1999.09.02 09:00,close,1109,0.78,1.06360,1.05241,1.06722,457.70,20691.98
1999.09.07 08:00,t/p,1111,0.85,1.05287,1.06509,1.05287,713.32,21405.30
1999.09.10 13:00,close,1112,0.78,1.04890,1.05655,1.04130,171.60,21576.90
1999.09.13 09:00,t/p,1113,0.96,1.03339,1.04457,1.03339,642.34,22219.24
1999.09.22 12:00,close,1114,0.78,1.04950,1.04475,1.06056,-70.20,22149.04
1999.09.23 20:00,s/l,1115,0.89,1.04813,1.04813,1.03580,-443.84,21705.20
1999.09.30 16:00,s/l,1116,0.74,1.06242,1.06242,1.07916,-168.72,21536.48
1999.10.12 15:00,s/l,1117,0.80,1.07052,1.07052,1.05562,-428.64,21107.84
1999.10.13 01:00,t/p,1118,1.09,1.07933,1.06945,1.07933,700.00,21807.83
1999.10.18 21:00,s/l,1119,0.85,1.08081,1.08081,1.09506,-637.33,21170.50
1999.10.26 11:00,t/p,1120,1.11,1.06295,1.07286,1.06295,1144.63,22315.14
1999.10.26 14:00,t/p,1121,0.89,1.05873,1.07253,1.05873,609.74,22924.88
1999.10.27 09:00,s/l,1122,1.12,1.06177,1.06177,1.05160,-457.97,22466.91
1999.10.29 14:00,s/l,1123,1.05,1.04938,1.04938,1.03868,-533.40,21933.51
1999.11.04 16:00,s/l,1124,1.02,1.04761,1.04761,1.05834,-529.38,21404.13
1999.11.05 15:00,s/l,1125,0.92,1.04254,1.04254,1.03095,-603.43,20800.70
1999.11.08 10:00,s/l,1126,0.99,1.04092,1.04092,1.05136,-413.82,20386.88
1999.11.11 11:00,s/l,1127,1.07,1.04059,1.04059,1.05011,-410.24,19976.64
1999.11.12 13:00,t/p,1128,1.14,1.03128,1.03998,1.03128,538.08,20514.72
1999.11.18 13:00,s/l,1129,1.10,1.03787,1.03787,1.04719,-412.94,20101.78
1999.11.18 16:00,t/p,1130,1.23,1.03253,1.04064,1.03253,537.51,20639.29
1999.11.19 14:00,t/p,1131,1.18,1.02516,1.03389,1.02516,745.88,21385.17
1999.11.24 13:00,t/p,1132,1.21,1.02071,1.02952,1.02071,637.79,22022.96
1999.11.26 17:00,s/l,1133,1.25,1.01635,1.01635,1.00747,-293.75,21729.21
1999.12.06 12:00,t/p,1134,1.10,1.01339,1.00357,1.01339,647.90,22377.11
1999.12.06 14:00,t/p,1135,1.04,1.02305,1.01230,1.02305,878.80,23255.91
1999.12.07 10:00,t/p,1136,1.01,1.02917,1.01772,1.02917,693.06,23948.97
1999.12.07 20:00,close,1137,0.84,1.02480,1.01475,1.03001,386.40,24335.37
1999.12.16 09:00,s/l,1138,1.13,1.00972,1.00972,0.99892,-293.35,24042.02
1999.12.17 08:00,t/p,1139,1.08,1.02253,1.01148,1.02253,715.18,24757.20
1999.12.17 08:00,t/p,1140,0.84,1.02278,1.00710,1.02278,846.05,25603.25
1999.12.24 06:00,s/l,1141,1.28,1.01167,1.01167,1.02200,-324.86,25278.38
1999.12.29 09:00,s/l,1142,1.40,1.01043,1.01043,1.00111,-202.86,25075.52
2000.01.03 08:00,s/l,1143,1.68,1.01381,1.01381,1.02128,-468.72,24606.80
2000.01.05 12:00,s/l,1144,1.25,1.03478,1.03478,1.04457,-490.00,24116.80
2000.01.10 17:00,close,1145,1.02,1.02530,1.02818,1.01507,-183.60,23933.20
2000.01.14 16:00,t/p,1146,1.03,1.01207,1.02362,1.01207,641.69,24574.89
2000.01.20 19:00,s/l,1147,1.01,1.01786,1.01786,1.00572,-643.77,23931.12
2000.01.28 13:00,close,1149,0.98,0.98460,0.98952,0.97546,350.94,24282.06
2000.01.28 16:00,t/p,1148,1.22,0.98171,0.99236,0.98171,1789.86,26071.92
2000.01.31 04:00,s/l,1150,1.23,0.98063,0.98063,0.97005,-522.63,25549.29
2000.02.03 13:00,s/l,1151,1.08,0.97130,0.97130,0.98306,-639.79,24909.50
2000.02.04 12:00,s/l,1152,0.98,0.98419,0.98419,0.99746,-472.16,24437.34
2000.02.04 14:00,s/l,1153,0.84,0.98126,0.98126,0.99762,-490.56,23946.78
2000.02.04 19:00,s/l,1154,0.76,0.98383,0.98383,0.96639,-473.48,23473.30
2000.02.08 16:00,s/l,1155,0.84,0.98487,0.98487,0.99869,-464.52,23008.78
2000.02.11 16:00,s/l,1156,0.86,0.98483,0.98483,0.97150,-458.38,22550.40
2000.02.17 10:00,t/p,1157,0.87,0.99116,0.97823,0.99116,672.34,23222.73
2000.02.22 09:00,t/p,1158,1.21,0.99762,0.98808,0.99762,692.12,23914.85
2000.02.24 09:00,s/l,1159,0.80,0.99866,0.99866,1.01585,42.24,23957.09
2000.02.25 08:00,t/p,1160,1.17,0.98689,0.99741,0.98689,1309.35,25266.44
2000.02.28 10:00,s/l,1161,0.80,0.97189,0.97189,0.95427,-503.20,24763.24
2000.03.03 09:00,s/l,1162,0.80,0.96754,0.96754,0.95220,-492.72,24270.52
2000.03.06 10:00,s/l,1163,0.79,0.96281,0.96281,0.94753,-482.69,23787.83
2000.03.07 21:00,s/l,1164,0.80,0.95950,0.95950,0.94474,-472.00,23315.83
2000.03.10 12:00,s/l,1165,0.79,0.96266,0.96266,0.97725,-461.99,22853.84
2000.03.22 00:00,t/p,1166,1.27,0.95982,0.96879,0.95982,693.55,23547.39
2000.03.23 14:00,s/l,1167,0.98,0.96599,0.96599,0.95258,-475.01,23072.38
2000.03.24 18:00,t/p,1168,1.35,0.97584,0.96694,0.97584,1165.32,24237.70
2000.04.04 18:00,t/p,1169,1.08,0.97223,0.96101,0.97223,726.84,24964.54
2000.04.04 20:00,s/l,1170,1.02,0.96123,0.96123,0.97341,-496.74,24467.80
2000.04.14 15:00,s/l,1171,1.17,0.95724,0.95724,0.96763,-486.72,23981.08
2000.04.17 09:00,s/l,1172,1.15,0.96086,0.96086,0.97122,-476.10,23504.98
2000.04.20 04:00,s/l,1173,1.22,0.94169,0.94169,0.93197,-603.53,22901.45
2000.04.25 18:00,t/p,1174,1.27,0.92081,0.93029,0.92081,1357.63,24259.08
2000.04.25 19:00,t/p,1175,1.00,0.91891,0.93196,0.91891,839.00,25098.08
2000.04.26 11:00,close,1176,1.06,0.91960,0.92413,0.91089,-21.20,25076.88
2000.04.28 07:00,s/l,1177,1.15,0.91252,0.91252,0.90121,41.52,25118.39
2000.05.05 11:00,s/l,1178,0.83,0.89991,0.89991,0.88308,-505.14,24613.25
2000.05.05 15:00,s/l,1179,0.93,0.89324,0.89324,0.90640,-489.18,24124.07
2000.05.11 01:00,s/l,1180,0.96,0.90188,0.90188,0.91492,-72.19,24051.88
2000.05.15 14:00,s/l,1181,0.94,0.91276,0.91276,0.92560,-426.76,23625.12
2000.05.15 20:00,s/l,1182,0.72,0.91149,0.91149,0.93000,-475.92,23149.20
2000.05.19 14:00,s/l,1183,0.96,0.89138,0.89138,0.87917,-391.68,22757.52
2000.05.24 12:00,close,1184,0.69,0.91050,0.89796,0.91627,412.90,23170.42
2000.05.25 15:00,s/l,1185,0.77,0.90738,0.90738,0.89064,-460.46,22709.96
2000.05.26 15:00,t/p,1186,0.73,0.92529,0.90804,0.92529,809.57,23519.53
2000.05.29 12:00,s/l,1187,0.90,0.92614,0.92614,0.93930,-456.12,23063.41
2000.05.30 07:00,close,1188,0.73,0.93090,0.92354,0.94135,72.42,23135.82
2000.05.30 16:00,s/l,1189,0.91,0.93220,0.93220,0.94570,100.10,23235.92
2000.06.02 15:00,s/l,1190,0.82,0.94356,0.94356,0.95765,-462.48,22773.44
2000.06.05 19:00,close,1191,0.68,0.94760,0.93703,0.95571,264.66,23038.10
2000.06.06 18:00,s/l,1192,0.86,0.95294,0.95294,0.96684,-48.16,22989.94
2000.06.09 17:00,s/l,1194,0.89,0.95364,0.95364,0.94080,-457.46,22532.48
2000.06.12 03:00,close,1193,0.67,0.95020,0.95532,0.93623,-115.17,22417.31
2000.06.15 09:00,s/l,1195,0.93,0.95348,0.95348,0.96552,-525.64,21891.67
2000.06.16 16:00,t/p,1196,1.01,0.96369,0.95287,0.96369,655.49,22547.16
2000.06.19 14:00,s/l,1197,0.98,0.96060,0.96060,0.97210,-451.58,22095.58
2000.06.22 13:00,s/l,1199,1.06,0.94273,0.94273,0.93216,-448.38,21647.20
2000.06.22 15:00,close,1198,0.74,0.93940,0.95156,0.93487,454.58,22101.78
2000.06.30 08:00,t/p,1200,1.01,0.95734,0.94628,0.95734,801.13,22902.91
2000.06.30 13:00,s/l,1201,1.07,0.95463,0.95463,0.96531,-456.89,22446.02
2000.07.10 20:00,s/l,1202,0.94,0.95533,0.95533,0.94208,-446.41,21999.61
2000.07.13 12:00,t/p,1203,1.25,0.93453,0.94331,0.93453,651.63,22651.24
2000.07.18 18:00,t/p,1204,1.41,0.92718,0.93522,0.92718,679.62,23330.86
2000.07.19 09:00,t/p,1205,1.37,0.92096,0.92986,0.92096,852.28,24183.14
2000.07.19 17:00,close,1206,1.10,0.92110,0.92808,0.91582,462.00,24645.14
2000.07.21 17:00,close,1208,1.17,0.93690,0.93023,0.94219,573.30,25218.44
2000.07.25 08:00,t/p,1207,1.32,0.93816,0.92889,0.93816,730.75,25949.19
2000.07.27 16:00,s/l,1209,1.40,0.93640,0.93640,0.94591,-200.48,25748.71
2000.08.02 08:00,s/l,1210,1.40,0.91790,0.91790,0.90790,683.34,26432.05
2000.08.04 15:00,s/l,1211,1.27,0.90825,0.90825,0.89787,-808.86,25623.18
2000.08.09 08:00,t/p,1212,1.27,0.89835,0.90843,0.89835,765.94,26389.12
2000.08.09 15:00,close,1213,1.03,0.89700,0.90662,0.89256,471.84,26860.96
2000.08.17 04:00,close,1214,1.10,0.91480,0.90542,0.91908,491.48,27352.44
2000.08.21 11:00,t/p,1215,1.56,0.90263,0.91142,0.90263,819.16,28171.60
2000.08.22 09:00,close,1216,1.16,0.89860,0.90826,0.89466,554.60,28726.20
2000.08.23 03:00,t/p,1217,1.65,0.89339,0.90208,0.89339,856.51,29582.71
2000.09.01 15:00,t/p,1218,1.62,0.89976,0.89066,0.89976,884.52,30467.23
2000.09.05 06:00,s/l,1219,1.58,0.89565,0.89565,0.90528,-658.23,29809.00
2000.09.05 06:00,s/l,1220,1.31,0.89604,0.89604,0.90908,-611.51,29197.50
2000.09.06 07:00,t/p,1221,1.45,0.88215,0.89223,0.88215,628.00,29825.49
2000.09.07 13:00,s/l,1222,1.17,0.87233,0.87233,0.85741,-115.48,29710.01
2000.09.08 19:00,s/l,1223,1.24,0.87047,0.87047,0.85854,-591.48,29118.53
2000.09.20 09:00,t/p,1224,1.06,0.84553,0.85915,0.84553,861.99,29980.52
2000.09.22 13:00,t/p,1225,0.98,0.89367,0.87839,0.89367,898.66,30879.18
2000.09.22 16:00,s/l,1226,1.01,0.88009,0.88009,0.89537,-617.11,30262.07
2000.09.25 14:00,s/l,1227,0.82,0.87437,0.87437,0.89490,-601.72,29660.36
2000.09.29 16:00,s/l,1228,1.09,0.88425,0.88425,0.87062,-574.32,29086.04
2000.10.06 11:00,s/l,1229,1.15,0.87405,0.87405,0.86143,-582.93,28503.10
2000.10.16 14:00,t/p,1230,1.71,0.85008,0.85778,0.85008,1111.67,29614.77
2000.10.17 19:00,s/l,1231,1.30,0.85314,0.85314,0.84042,-592.67,29022.10
2000.10.18 13:00,s/l,1232,1.64,0.85136,0.85136,0.86022,-663.87,28358.23
2000.10.18 17:00,t/p,1233,1.38,0.83324,0.84351,0.83324,850.08,29208.31
2000.10.19 00:00,s/l,1234,1.36,0.84068,0.84068,0.82999,-589.83,28618.48
2000.10.19 11:00,s/l,1235,1.16,0.84424,0.84424,0.83041,-579.65,28038.83
2000.10.26 07:00,t/p,1236,1.35,0.82404,0.83464,0.82404,1174.91,29213.73
2000.10.30 11:00,t/p,1237,1.26,0.84771,0.83619,0.84771,630.25,29843.98
2000.10.30 12:00,t/p,1238,1.08,0.85044,0.83544,0.85044,1040.26,30884.24
2000.10.30 17:00,s/l,1239,1.09,0.84156,0.84156,0.85736,-614.76,30269.48
2000.11.02 10:00,close,1240,1.06,0.85780,0.85383,0.86971,315.46,30584.94
2000.11.03 14:00,s/l,1241,1.21,0.86846,0.86846,0.88107,-609.84,29975.10
2000.11.10 18:00,s/l,1242,1.05,0.85985,0.85985,0.87448,-27.09,29948.01
2000.11.21 16:00,t/p,1243,1.23,0.84577,0.85799,0.84577,1029.88,30977.88
2000.11.21 16:00,close,1244,1.04,0.84560,0.85375,0.83738,237.22,31215.11
2000.11.24 09:00,close,1245,1.12,0.83970,0.84453,0.82905,-80.53,31134.58
2000.11.28 13:00,close,1246,1.28,0.85520,0.84785,0.86144,320.00,31454.58
2000.11.30 10:00,t/p,1247,1.31,0.86949,0.85613,0.86949,1122.15,32576.73
2000.12.04 23:00,s/l,1248,1.48,0.88522,0.88522,0.89617,-648.24,31928.49
2000.12.07 16:00,s/l,1249,1.18,0.88841,0.88841,0.90350,-718.62,31209.87
2000.12.14 22:00,t/p,1250,1.34,0.89264,0.88107,0.89264,929.96,32139.83
2000.12.22 08:00,t/p,1251,1.06,0.91768,0.90076,0.91768,1149.89,33289.71
2000.12.26 11:00,t/p,1252,1.46,0.92992,0.91855,0.92992,993.38,34283.10
2001.01.02 09:00,t/p,1253,1.70,0.94551,0.93533,0.94551,1205.98,35489.08
2001.01.04 08:00,s/l,1254,1.46,0.93358,0.93358,0.92087,-49.20,35439.88
2001.01.05 14:00,s/l,1255,1.09,0.94792,0.94792,0.96607,-706.32,34733.56
2001.01.15 07:00,s/l,1256,1.16,0.94553,0.94553,0.96071,-346.38,34387.18
2001.01.15 07:00,s/l,1257,1.00,0.94581,0.94581,0.96538,-700.60,33686.58
2001.01.19 11:00,close,1258,0.97,0.94440,0.93427,0.95367,309.62,33996.20
2001.01.25 12:00,t/p,1259,1.01,0.91359,0.93243,0.91359,1217.35,35213.56
2001.01.31 15:00,close,1261,1.15,0.93220,0.92385,0.94136,161.00,35374.56
2001.01.31 20:00,t/p,1260,1.34,0.93485,0.92160,0.93485,1399.23,36773.79
2001.02.09 09:00,close,1262,1.21,0.91690,0.92436,0.90739,167.10,36940.89
2001.02.15 12:00,t/p,1263,1.76,0.90642,0.91689,0.90642,1052.48,37993.37
2001.02.16 08:00,s/l,1264,1.72,0.91211,0.91211,0.90108,-710.19,37283.18
2001.02.16 08:00,s/l,1265,1.35,0.91149,0.91149,0.89556,-419.71,36863.46
2001.02.21 10:00,s/l,1266,1.56,0.91358,0.91358,0.90139,124.96,36988.42
2001.02.26 10:00,s/l,1267,1.50,0.91184,0.91184,0.92424,-400.20,36588.22
2001.03.05 09:00,s/l,1268,1.48,0.93088,0.93088,0.94318,-729.34,35858.88
2001.03.13 17:00,t/p,1269,2.01,0.91608,0.92512,0.91608,1350.72,37209.60
2001.03.14 11:00,s/l,1270,1.40,0.91589,0.91589,0.90108,-740.60,36469.00
2001.03.23 10:00,s/l,1271,1.26,0.89356,0.89356,0.87743,-728.15,35740.84
2001.03.29 12:00,t/p,1272,1.46,0.88360,0.89576,0.88360,1054.70,36795.55
2001.04.11 14:00,t/p,1273,1.55,0.88102,0.89282,0.88102,1094.46,37890.00
2001.04.11 17:00,s/l,1274,1.59,0.88596,0.88596,0.87405,-756.84,37133.16
2001.04.17 07:00,s/l,1275,1.37,0.89020,0.89020,0.87508,-742.40,36390.76
2001.04.18 16:00,s/l,1276,1.66,0.87716,0.87716,0.86625,-723.76,35667.00
2001.04.25 01:00,s/l,1277,1.18,0.89276,0.89276,0.90967,-715.55,34951.45
2001.04.27 14:00,s/l,1278,1.56,0.89572,0.89572,0.90691,-700.13,34251.32
2001.05.02 23:00,s/l,1279,1.43,0.89742,0.89742,0.88511,-568.71,33682.61
2001.05.02 23:00,s/l,1280,1.25,0.89730,0.89730,0.88190,-692.25,32990.36
2001.05.04 15:00,s/l,1281,1.62,0.89514,0.89514,0.90528,-657.72,32332.64
2001.05.04 17:00,close,1282,1.16,0.89440,0.89149,0.90720,-313.20,32019.44
2001.05.10 12:00,s/l,1283,1.76,0.89002,0.89002,0.88096,-650.50,31368.94
2001.05.16 03:00,s/l,1285,1.43,0.87549,0.87549,0.88728,-431.57,30937.37
2001.05.16 08:00,t/p,1284,2.02,0.88196,0.87420,0.88196,1020.50,31957.87
2001.05.17 13:00,s/l,1286,1.86,0.87997,0.87997,0.88855,-642.44,31315.43
2001.05.18 20:00,s/l,1287,1.99,0.88013,0.88013,0.87230,-622.87,30692.56
2001.05.23 08:00,t/p,1288,1.88,0.86286,0.87126,0.86286,1601.95,32294.50
2001.05.23 10:00,t/p,1289,1.50,0.85751,0.86932,0.85751,1138.50,33433.00
2001.05.29 06:00,close,1290,1.49,0.85590,0.86267,0.85016,325.71,33758.72
2001.05.30 01:00,s/l,1291,1.85,0.85811,0.85811,0.84883,-449.37,33309.35
2001.06.01 06:00,close,1293,1.53,0.84650,0.85319,0.84117,364.29,33673.65
2001.06.04 04:00,s/l,1292,1.86,0.85068,0.85068,0.84174,-672.95,33000.70
2001.06.18 11:00,s/l,1294,1.48,0.85845,0.85845,0.87092,-659.78,32340.91
2001.06.20 10:00,close,1295,1.40,0.85350,0.86150,0.84863,473.34,32814.25
2001.06.29 20:00,s/l,1296,1.50,0.84966,0.84966,0.83745,-654.00,32160.25
2001.07.05 15:00,t/p,1297,2.08,0.83676,0.84449,0.83676,965.12,33125.37
2001.07.09 21:00,close,1299,1.63,0.85040,0.84216,0.85348,684.60,33809.97
2001.07.09 22:00,t/p,1298,1.89,0.85184,0.84311,0.85184,988.85,34798.82
2001.07.11 23:00,s/l,1300,1.92,0.85712,0.85712,0.86632,-629.76,34169.06
2001.07.18 15:00,t/p,1301,1.86,0.86590,0.85673,0.86590,1021.51,35190.57
2001.07.19 09:00,t/p,1302,1.72,0.87653,0.86632,0.87653,895.43,36086.01
2001.07.19 15:00,s/l,1303,1.69,0.86931,0.86931,0.88104,-712.17,35373.84
2001.08.03 15:00,t/p,1304,2.37,0.88445,0.87687,0.88445,1189.27,36563.11
2001.08.08 17:00,s/l,1305,2.54,0.87877,0.87877,0.87160,-733.81,35829.30
2001.08.09 17:00,t/p,1306,2.00,0.89315,0.88281,0.89315,1910.00,37739.30
2001.08.10 15:00,close,1307,1.93,0.89530,0.88800,0.89891,654.66,38393.96
2001.08.15 10:00,t/p,1308,2.38,0.90782,0.89978,0.90782,1145.26,39539.21
2001.08.16 08:00,t/p,1309,1.99,0.91785,0.90673,0.91785,1418.07,40957.29
2001.08.22 08:00,s/l,1310,2.13,0.91407,0.91407,0.92365,-817.49,40139.79
2001.08.23 17:00,s/l,1311,1.79,0.91676,0.91676,0.90427,-798.34,39341.45
2001.08.28 15:00,s/l,1312,2.18,0.90860,0.90860,0.89961,-784.80,38556.65
2001.08.28 16:00,s/l,1313,1.71,0.91007,0.91007,0.89727,-781.47,37775.18
2001.08.30 12:00,close,1314,1.78,0.90680,0.91174,0.89987,124.60,37899.78
2001.08.31 15:00,s/l,1315,2.16,0.91284,0.91284,0.92173,-641.09,37258.69
2001.08.31 21:00,s/l,1316,1.96,0.91260,0.91260,0.90311,-744.80,36513.89
2001.09.04 15:00,t/p,1317,2.04,0.89485,0.90376,0.89485,1091.40,37605.29
2001.09.04 16:00,t/p,1318,1.53,0.89057,0.90399,0.89057,1320.39,38925.68
2001.09.06 08:00,close,1319,1.50,0.88370,0.89387,0.87939,738.60,39664.28
2001.09.07 13:00,t/p,1320,1.87,0.90175,0.89116,0.90175,1185.95,40850.24
2001.09.11 06:00,s/l,1321,1.84,0.89728,0.89728,0.90833,-816.22,40034.01
2001.09.11 15:00,s/l,1322,1.66,0.90279,0.90279,0.91481,-798.46,39235.55
2001.09.11 22:00,s/l,1323,1.63,0.91100,0.91100,0.92376,863.90,40099.45
2001.09.14 11:00,t/p,1324,1.55,0.91846,0.90553,0.91846,1201.56,41301.01
2001.09.25 13:00,s/l,1325,1.29,0.92019,0.92019,0.90229,-826.76,40474.25
2001.09.27 06:00,s/l,1326,1.73,0.91893,0.91893,0.93086,-519.35,39954.91
2001.10.08 09:00,s/l,1327,2.09,0.92082,0.92082,0.92878,439.74,40394.64
2001.10.10 19:00,close,1329,1.92,0.91060,0.91811,0.90633,633.60,41028.24
2001.10.11 07:00,t/p,1328,2.55,0.90937,0.91726,0.90937,1186.77,42215.01
2001.10.12 08:00,close,1331,1.83,0.90320,0.90647,0.89367,-241.38,41973.64
2001.10.12 10:00,s/l,1330,2.50,0.90425,0.90425,0.89563,-767.25,41206.39
2001.10.15 15:00,s/l,1332,2.47,0.90684,0.90684,0.91550,-313.20,40893.19
2001.10.17 15:00,s/l,1333,1.93,0.90753,0.90753,0.89568,-816.39,40076.80
2001.10.22 14:00,t/p,1334,2.43,0.89447,0.90269,0.89447,1193.37,41270.17
2001.10.22 15:00,t/p,1335,1.96,0.89134,0.90279,0.89134,1438.84,42709.01
2001.10.24 11:00,s/l,1336,2.47,0.89415,0.89415,0.88553,-861.54,41847.47
2001.10.30 15:00,close,1338,2.14,0.90740,0.90117,0.91217,492.20,42339.67
2001.10.30 16:00,t/p,1337,2.72,0.90851,0.90082,0.90851,1251.74,43591.42
2001.10.30 17:00,s/l,1339,2.80,0.90579,0.90579,0.91356,-870.80,42720.62
2001.11.07 06:00,s/l,1340,2.69,0.89718,0.89718,0.88947,264.16,42984.78
2001.11.09 16:00,s/l,1341,2.47,0.89448,0.89448,0.88577,-592.55,42392.22
2001.11.15 16:00,close,1342,1.92,0.88110,0.88681,0.87446,235.01,42627.23
2001.12.03 10:00,s/l,1343,3.22,0.89298,0.89298,0.89978,-524.22,42103.01
2001.12.05 16:00,s/l,1344,3.25,0.89062,0.89062,0.89708,-838.50,41264.51
2001.12.07 09:00,s/l,1345,2.87,0.89163,0.89163,0.89906,6.31,41270.83
2001.12.07 17:00,s/l,1346,2.36,0.88868,0.88868,0.89826,-1422.61,39848.22
2001.12.11 15:00,close,1347,2.29,0.89010,0.88693,0.89664,-68.70,39779.52
2001.12.12 10:00,s/l,1348,2.70,0.89416,0.89416,0.90151,-793.80,38985.72
2001.12.14 07:00,s/l,1349,2.56,0.89644,0.89644,0.88883,-706.30,38279.42
2001.12.19 14:00,s/l,1350,2.60,0.89888,0.89888,0.89142,-644.80,37634.62
2001.12.27 09:00,s/l,1351,1.85,0.88347,0.88347,0.87180,-493.02,37141.59
2002.01.02 02:00,close,1352,1.76,0.89070,0.88519,0.89698,225.98,37367.58
2002.01.03 17:00,s/l,1353,1.69,0.89899,0.89899,0.91133,-749.35,36618.23
2002.01.07 15:00,s/l,1354,1.71,0.89266,0.89266,0.88201,-728.46,35889.77
2002.01.09 22:00,s/l,1355,2.07,0.89171,0.89171,0.88293,-664.47,35225.30
2002.01.14 13:00,s/l,1356,2.26,0.89168,0.89168,0.89947,-772.92,34452.38
2002.01.17 19:00,close,1358,1.83,0.88110,0.88805,0.87755,575.17,35027.55
2002.01.18 16:00,close,1357,2.17,0.88370,0.88613,0.87806,109.58,35137.13
2002.01.22 03:00,s/l,1359,2.77,0.88235,0.88235,0.88873,-378.38,34758.75
2002.01.25 10:00,t/p,1360,2.85,0.87375,0.87984,0.87375,1018.59,35777.34
2002.01.28 12:00,t/p,1361,2.54,0.86169,0.86887,0.86169,1674.11,37451.46
2002.01.28 13:00,t/p,1362,2.07,0.85909,0.86797,0.85909,1509.24,38960.69
2002.01.30 14:00,s/l,1363,2.65,0.86186,0.86186,0.86921,-781.22,38179.47
2002.02.08 18:00,close,1364,1.94,0.87300,0.86917,0.88017,-19.40,38160.07
2002.02.11 21:00,s/l,1365,2.54,0.87590,0.87590,0.88341,-762.00,37398.07
2002.02.20 10:00,s/l,1366,2.74,0.87513,0.87513,0.88206,-377.57,37020.50
2002.02.25 08:00,s/l,1367,2.66,0.87364,0.87364,0.88079,-124.49,36896.01
2002.02.26 12:00,close,1368,2.19,0.86790,0.87257,0.86314,284.70,37180.71
2002.02.27 16:00,s/l,1369,2.45,0.86613,0.86613,0.85856,-918.51,36262.21
2002.03.01 16:00,s/l,1370,2.46,0.86596,0.86596,0.87331,-725.21,35537.00
2002.03.07 08:00,t/p,1371,2.42,0.88130,0.87397,0.88130,1058.99,36595.99
2002.03.26 15:00,s/l,1372,3.08,0.87620,0.87620,0.87021,-677.60,35918.39
2002.03.28 20:00,close,1373,2.23,0.87040,0.87632,0.86730,589.39,36507.78
2002.04.02 00:00,s/l,1374,3.18,0.87918,0.87918,0.88499,-167.90,36339.88
2002.04.02 08:00,s/l,1375,2.43,0.87778,0.87778,0.88624,-735.80,35604.07
2002.04.04 15:00,s/l,1376,3.19,0.88253,0.88253,0.88821,-692.23,34911.84
2002.04.12 00:00,s/l,1377,2.91,0.88139,0.88139,0.88742,-616.34,34295.50
2002.04.16 00:00,close,1378,2.42,0.87980,0.88263,0.87470,-9.20,34286.31
2002.04.17 09:00,t/p,1379,3.03,0.88659,0.88094,0.88659,1055.05,35341.35
2002.04.25 08:00,t/p,1380,3.25,0.89526,0.88983,0.89526,1051.70,36393.05
2002.04.26 09:00,s/l,1382,3.30,0.89643,0.89643,0.90211,-421.74,35971.31
2002.04.26 23:00,t/p,1381,2.67,0.90246,0.89459,0.90246,1962.98,37934.30
2002.04.30 16:00,s/l,1383,3.48,0.89990,0.89990,0.90540,-733.58,37200.71
2002.05.02 09:00,s/l,1384,3.35,0.90479,0.90479,0.91056,-513.89,36686.82
2002.05.02 12:00,s/l,1385,2.57,0.90322,0.90322,0.91129,-746.33,35940.50
2002.05.09 15:00,s/l,1386,2.09,0.90864,0.90864,0.89901,-730.87,35209.62
2002.05.15 03:00,t/p,1387,1.90,0.90034,0.91070,0.90034,1261.79,36471.41
2002.05.15 20:00,t/p,1388,2.13,0.91208,0.90344,0.91208,1124.64,37596.05
2002.05.16 12:00,close,1389,1.93,0.91290,0.90742,0.91828,308.80,37904.85
2002.05.23 16:00,s/l,1390,2.27,0.92203,0.92203,0.91370,-755.91,37148.94
2002.05.29 09:00,close,1392,1.85,0.92880,0.92508,0.93662,-75.48,37073.46
2002.05.29 10:00,t/p,1391,2.47,0.93127,0.92348,0.93127,1596.11,38669.58
2002.05.31 21:00,s/l,1393,2.49,0.93350,0.93350,0.92575,-771.90,37897.68
2002.06.03 15:00,s/l,1394,2.54,0.93448,0.93448,0.92704,-756.92,37140.76
2002.06.04 19:00,s/l,1395,1.75,0.94057,0.94057,0.95241,-740.25,36400.51
2002.06.07 22:00,s/l,1396,2.08,0.94238,0.94238,0.95117,-567.42,35833.08
2002.06.20 11:00,close,1397,1.65,0.95820,0.95138,0.96348,408.54,36241.62
2002.06.24 04:00,s/l,1398,2.09,0.96803,0.96803,0.97670,-580.60,35661.02
2002.06.26 00:00,t/p,1399,1.90,0.98342,0.97406,0.98342,1066.28,36727.30
2002.06.26 16:00,s/l,1400,1.47,0.98631,0.98631,1.00028,-439.53,36287.77
2002.07.09 04:00,close,1401,1.35,0.98840,0.98503,1.00007,-271.08,36016.69
2002.07.16 10:00,t/p,1402,1.23,1.01372,0.99736,1.01372,1292.98,37309.67
2002.07.29 15:00,t/p,1403,1.47,0.97984,0.99310,0.97984,1770.03,39079.69
2002.07.29 15:00,t/p,1404,1.28,0.97743,0.99387,0.97743,1352.96,40432.65
2002.07.30 01:00,close,1405,1.31,0.98080,0.98465,0.96742,-303.79,40128.87
2002.08.01 09:00,close,1406,1.29,0.97350,0.98370,0.96633,508.65,40637.51
2002.08.07 16:00,s/l,1407,1.31,0.97180,0.97180,0.95443,-814.69,39822.82
2002.08.14 18:00,s/l,1408,1.37,0.98262,0.98262,0.99880,-791.86,39030.96
2002.08.23 15:00,s/l,1410,1.48,0.97299,0.97299,0.95818,-782.92,38248.04
2002.08.23 22:00,s/l,1409,1.90,0.97379,0.97379,0.96357,-780.71,37467.33
2002.09.02 15:00,s/l,1411,2.05,0.98434,0.98434,0.97524,-770.60,36696.74
2002.09.04 15:00,s/l,1413,1.71,0.99164,0.99164,1.00385,-746.93,35949.81
2002.09.05 09:00,t/p,1412,2.08,0.99767,0.98889,0.99767,1089.50,37039.31
2002.09.09 08:00,t/p,1414,2.03,0.97953,0.98864,0.97953,1126.85,38166.17
2002.09.10 09:00,close,1415,1.70,0.97640,0.98498,0.97244,693.77,38859.94
2002.09.11 18:00,s/l,1416,2.14,0.97525,0.97525,0.96612,-866.70,37993.24
2002.09.13 16:00,s/l,1417,2.16,0.97689,0.97689,0.98566,-759.89,37233.35
2002.09.16 16:00,s/l,1418,2.02,0.97248,0.97248,0.96303,363.80,37597.15
2002.09.18 21:00,close,1419,1.64,0.97790,0.96723,0.98002,1000.40,38597.55
2002.09.30 15:00,t/p,1420,2.13,0.98905,0.97996,0.98905,1224.75,39822.30
2002.10.04 22:00,t/p,1421,2.56,0.97834,0.98611,0.97834,1192.96,41015.26
2002.10.07 15:00,s/l,1422,1.94,0.98272,0.98272,0.97090,-818.68,40196.58
2002.10.10 09:00,t/p,1423,2.70,0.99156,0.98396,0.99156,1575.72,41772.30
2002.10.10 13:00,s/l,1424,2.08,0.98613,0.98613,0.99724,-825.76,40946.54
2002.10.15 18:00,t/p,1425,2.81,0.97924,0.98651,0.97924,1140.86,42087.40
2002.10.17 17:00,t/p,1426,2.34,0.97105,0.98108,0.97105,1509.30,43596.70
2002.10.21 09:00,s/l,1427,2.31,0.97497,0.97497,0.96441,-879.65,42717.05
2002.11.01 16:00,s/l,1428,3.16,0.99636,0.99636,1.00347,-107.44,42609.61
2002.11.04 14:00,close,1429,2.45,0.99560,0.99303,1.00274,-222.46,42387.15
2002.11.19 18:00,s/l,1430,2.68,1.00958,1.00958,1.01737,285.15,42672.31
2002.11.21 00:00,close,1431,2.07,1.00110,1.00642,0.99489,236.60,42908.91
2002.11.27 16:00,close,1432,2.12,0.98990,0.99633,0.98505,309.94,43218.85
2002.12.02 16:00,s/l,1433,3.12,0.99013,0.99013,0.98305,-539.76,42679.09
2002.12.10 09:00,t/p,1434,3.05,1.01249,1.00550,1.01249,1273.07,43952.16
2002.12.10 09:00,close,1435,2.40,1.01250,1.00622,1.01624,646.08,44598.24
2002.12.12 17:00,t/p,1436,3.29,1.01730,1.01030,1.01730,1842.40,46440.64
2002.12.13 10:00,t/p,1437,2.76,1.02484,1.01545,1.02484,1667.04,48107.68
2002.12.13 14:00,close,1438,2.68,1.02380,1.02021,1.03026,0.00,48107.68
2002.12.17 15:00,t/p,1439,3.11,1.03293,1.02521,1.03293,1439.93,49547.61
2002.12.23 14:00,s/l,1440,3.33,1.02867,1.02867,1.03625,-376.29,49171.32
2002.12.26 22:00,t/p,1441,2.51,1.03784,1.02689,1.03784,1759.01,50930.33
2003.01.03 05:00,s/l,1442,3.26,1.03803,1.03803,1.02995,-341.97,50588.35
2003.01.07 01:00,s/l,1443,2.39,1.04347,1.04347,1.05531,-1012.88,49575.47
2003.01.08 17:00,s/l,1444,2.97,1.04013,1.04013,1.03180,-989.01,48586.46
2003.01.09 15:00,s/l,1446,2.34,1.04720,1.04720,1.05897,-982.80,47603.66
2003.01.10 14:00,t/p,1445,2.73,1.05476,1.04549,1.05476,1618.34,49222.01
2003.01.17 10:00,t/p,1447,2.88,1.06665,1.05806,1.06665,1452.10,50674.10
2003.01.22 12:00,s/l,1448,2.40,1.06868,1.06868,1.08050,-1012.80,49661.30
2003.01.27 10:00,t/p,1449,3.39,1.08759,1.08027,1.08759,1485.50,51146.80
2003.02.05 20:00,s/l,1450,2.28,1.07968,1.07968,1.06848,-1021.44,50125.36
2003.02.14 14:00,s/l,1451,1.78,1.07800,1.07800,1.09369,-998.22,49127.14
2003.02.18 23:00,close,1452,1.84,1.06870,1.07772,1.06282,677.30,49804.44
2003.02.21 19:00,s/l,1453,1.83,1.07708,1.07708,1.09142,-865.22,48939.22
2003.02.24 00:00,t/p,1454,2.60,1.07331,1.08280,1.07331,1396.46,50335.68
2003.02.24 09:00,s/l,1455,2.88,1.07660,1.07660,1.06785,-1008.00,49327.68
2003.03.04 23:00,t/p,1456,2.74,1.09369,1.08470,1.09369,1474.67,50802.34
2003.03.04 23:00,close,1457,2.23,1.09560,1.08639,1.09901,1449.50,52251.84
2003.03.06 02:00,s/l,1458,3.07,1.09430,1.09430,1.10281,-1051.17,51200.68
2003.03.13 03:00,s/l,1459,2.92,1.08970,1.08970,1.08096,-1022.00,50178.68
2003.03.13 09:00,s/l,1461,2.86,1.09170,1.09170,1.08296,-1001.00,49177.68
2003.03.13 19:00,t/p,1460,2.30,1.08105,1.09326,1.08105,1644.50,50822.18
2003.03.18 03:00,s/l,1462,2.25,1.06511,1.06511,1.05384,-1019.03,49803.15
2003.03.28 14:00,close,1463,1.74,1.07650,1.06478,1.08079,1042.61,50845.76
2003.04.02 03:00,close,1464,1.65,1.09200,1.08375,1.10098,327.36,51173.12
2003.04.04 04:00,close,1465,1.71,1.07230,1.08217,1.06545,663.65,51836.77
2003.04.07 08:00,t/p,1466,2.53,1.05795,1.06820,1.05795,1682.45,53519.22
2003.04.17 17:00,s/l,1467,2.00,1.08797,1.08797,1.10290,-1066.00,52453.22
2003.04.22 07:00,s/l,1468,2.99,1.08890,1.08890,1.08014,-1859.48,50593.74
2003.04.24 06:00,close,1469,1.94,1.09970,1.09211,1.10665,459.39,51053.13
2003.04.25 09:00,s/l,1470,2.77,1.09862,1.09862,1.10783,-1104.68,49948.46
2003.04.30 00:00,t/p,1471,2.55,1.11236,1.10242,1.11236,1696.26,51644.72
2003.05.01 00:00,close,1472,2.19,1.11720,1.10758,1.12079,1243.04,52887.76
2003.05.02 14:00,s/l,1473,2.64,1.11983,1.11983,1.13000,-1683.79,51203.97
2003.05.07 14:00,s/l,1474,2.05,1.13762,1.13762,1.15156,-1022.54,50181.43
2003.05.12 00:00,t/p,1475,2.03,1.15462,1.14225,1.15462,1503.01,51684.44
2003.05.12 03:00,close,1476,1.77,1.15690,1.14379,1.15978,1308.38,52992.82
2003.05.13 00:00,s/l,1477,2.10,1.15206,1.15206,1.16466,-1060.08,51932.74
2003.05.19 19:00,s/l,1478,1.57,1.16191,1.16191,1.18036,-1034.63,50898.11
2003.05.26 22:00,close,1480,1.60,1.18450,1.17470,1.19262,544.00,51442.11
2003.05.27 01:00,t/p,1479,2.06,1.18713,1.17458,1.18713,1671.48,53113.60
2003.05.30 09:00,s/l,1481,1.97,1.18329,1.18329,1.19732,-23.25,53090.35
2003.06.04 05:00,close,1482,1.58,1.17140,1.18019,1.16145,325.80,53416.15
2003.06.06 13:00,s/l,1483,1.91,1.17673,1.17673,1.19091,-778.90,52637.25
2003.06.06 13:00,s/l,1484,1.49,1.17707,1.17707,1.19508,-1033.76,51603.49
2003.06.09 13:00,s/l,1485,1.74,1.17547,1.17547,1.16054,-467.89,51135.60
2003.06.16 16:00,s/l,1486,2.00,1.18374,1.18374,1.19614,126.40,51262.00
2003.06.19 03:00,t/p,1487,1.50,1.16004,1.17911,1.16004,1830.45,53092.45
2003.06.24 00:00,close,1488,1.67,1.15460,1.16285,1.14507,314.13,53406.58
2003.06.25 09:00,s/l,1489,2.17,1.15328,1.15328,1.14083,-780.98,52625.60
2003.06.27 10:00,close,1490,1.67,1.14100,1.14811,1.13212,631.43,53257.02
2003.07.01 15:00,t/p,1491,2.23,1.15735,1.14526,1.15735,2038.67,55295.69
2003.07.03 13:00,s/l,1492,2.48,1.15054,1.15054,1.13943,-1150.72,54144.97
2003.07.07 11:00,t/p,1493,2.84,1.13560,1.14510,1.13560,1618.80,55763.77
2003.07.08 16:00,close,1494,1.96,1.12590,1.13799,1.12261,1662.28,57426.04
2003.07.16 15:00,s/l,1495,3.02,1.11998,1.11998,1.11029,-392.30,57033.75
2003.07.25 12:00,close,1496,2.14,1.14850,1.14168,1.15658,314.15,57347.90
2003.07.28 00:00,s/l,1497,2.54,1.14949,1.14949,1.16076,-1147.57,56200.33
2003.07.31 16:00,t/p,1498,2.12,1.12390,1.13852,1.12390,2849.92,59050.24
2003.08.01 15:00,s/l,1499,2.12,1.12316,1.12316,1.10760,-1178.72,57871.52
2003.08.05 21:00,close,1500,1.97,1.13900,1.12974,1.14615,668.22,58539.75
2003.08.13 13:00,close,1501,2.12,1.12610,1.13214,1.11802,780.37,59320.12
2003.08.21 04:00,close,1502,2.18,1.10870,1.11818,1.10368,1352.69,60672.81
2003.08.21 17:00,t/p,1503,3.00,1.09403,1.10414,1.09403,1821.00,62493.81
2003.08.21 17:00,t/p,1504,2.31,1.09066,1.10535,1.09066,2180.64,64674.45
2003.08.22 17:00,s/l,1506,2.96,1.08839,1.08839,1.07716,-1329.04,63345.41
2003.08.25 23:00,close,1505,2.32,1.08270,1.09775,1.08220,2195.18,65540.59
2003.09.02 07:00,s/l,1507,2.40,1.09134,1.09134,1.10663,-1314.24,64226.35
2003.09.03 16:00,s/l,1508,2.39,1.08456,1.08456,1.06955,-1281.04,62945.31
2003.09.08 21:00,s/l,1510,2.19,1.10635,1.10635,1.12301,-1303.05,61642.26
2003.09.09 12:00,t/p,1509,2.76,1.11423,1.10251,1.11423,3012.26,64654.53
2003.09.11 08:00,close,1511,2.08,1.12530,1.11241,1.12974,1388.61,66043.13
2003.09.11 13:00,s/l,1512,2.65,1.12052,1.12052,1.13296,-1319.70,64723.43
2003.09.15 08:00,s/l,1513,2.45,1.12500,1.12500,1.13825,-1618.96,63104.47
2003.09.23 03:00,close,1514,1.89,1.14810,1.13564,1.15428,1094.69,64199.16
2003.09.29 15:00,s/l,1515,3.05,1.14761,1.14761,1.13709,-1192.55,63006.61
2003.09.30 18:00,s/l,1516,2.07,1.16253,1.16253,1.17953,-1256.49,61750.12
2003.10.06 14:00,s/l,1517,2.82,1.16411,1.16411,1.15284,-515.78,61234.34
2003.10.06 14:00,s/l,1518,2.06,1.16410,1.16410,1.14701,-1256.60,59977.74
2003.10.08 07:00,close,1519,1.98,1.18210,1.17046,1.18822,2273.83,62251.58
2003.10.16 08:00,close,1520,1.79,1.15950,1.17083,1.15143,777.40,63028.97
2003.10.23 15:00,s/l,1522,1.96,1.17598,1.17598,1.19423,-1277.92,61751.05
2003.10.27 04:00,s/l,1521,2.35,1.17494,1.17494,1.18858,-822.50,60928.55
2003.11.03 12:00,s/l,1523,3.32,1.16088,1.16088,1.15169,-989.36,59939.19
2003.11.04 16:00,s/l,1524,2.77,1.14972,1.14972,1.13891,-1201.90,58737.29
2003.11.05 12:00,close,1525,2.30,1.14560,1.15213,1.13721,198.26,58935.55
2003.11.10 11:00,s/l,1526,3.12,1.14787,1.14787,1.15769,175.34,59110.89
2003.11.18 22:00,t/p,1527,2.70,1.19585,1.18493,1.19585,1795.50,60906.39
2003.11.19 18:00,s/l,1528,2.17,1.18874,1.18874,1.20430,-1316.76,59589.64
2003.11.25 11:00,close,1530,2.17,1.17630,1.18245,1.16692,126.08,59715.72
2003.11.26 15:00,s/l,1529,2.55,1.18573,1.18573,1.17390,-1496.34,58219.38
2003.12.02 16:00,t/p,1531,2.43,1.20483,1.19312,1.20483,3008.83,61228.20
2003.12.04 15:00,t/p,1532,2.82,1.21513,1.20425,1.21513,1860.64,63088.84
2003.12.10 08:00,s/l,1533,2.18,1.21683,1.21683,1.23299,-1021.55,62067.29
2003.12.22 10:00,t/p,1534,3.07,1.24390,1.23373,1.24390,1952.52,64019.81
2003.12.24 23:00,s/l,1535,3.75,1.24303,1.24303,1.25171,-888.75,63131.06
2003.12.31 18:00,s/l,1536,2.97,1.25800,1.25800,1.27005,888.62,64019.68
2004.01.12 14:00,s/l,1537,2.53,1.28235,1.28235,1.29650,-1277.65,62742.03
2004.01.14 17:00,s/l,1538,2.31,1.27093,1.27093,1.25735,-1254.33,61487.70
2004.01.20 08:00,s/l,1539,1.88,1.24335,1.24335,1.22473,-426.57,61061.13
2004.01.20 16:00,t/p,1540,2.07,1.25702,1.24198,1.25702,2343.24,63404.37
2004.01.29 16:00,t/p,1541,1.85,1.23852,1.25565,1.23852,1891.25,65295.63
2004.02.02 18:00,s/l,1542,1.92,1.23940,1.23940,1.25639,-1307.14,63988.49
2004.02.04 16:00,s/l,1543,2.02,1.24957,1.24957,1.26540,-1280.28,62708.21
2004.02.06 10:00,s/l,1544,2.05,1.25219,1.25219,1.26747,-1295.19,61413.02
2004.02.11 09:00,s/l,1545,1.97,1.26487,1.26487,1.28044,-1232.04,60180.99
2004.02.13 16:00,s/l,1546,2.17,1.28233,1.28233,1.29476,151.47,60332.45
2004.02.17 08:00,s/l,1547,2.28,1.27907,1.27907,1.26589,-959.42,59373.03
2004.02.18 07:00,t/p,1548,2.45,1.29105,1.27896,1.29105,1627.29,61000.32
2004.02.19 00:00,s/l,1549,2.23,1.27192,1.27192,1.25761,161.23,61161.55
2004.02.23 13:00,s/l,1550,1.76,1.25835,1.25835,1.23889,-1223.20,59938.35
2004.02.25 12:00,s/l,1551,1.96,1.26340,1.26340,1.27865,-1197.17,58741.18
2004.02.26 14:00,t/p,1552,1.95,1.24091,1.25640,1.24091,2541.44,61282.61
2004.02.26 16:00,close,1553,1.57,1.24220,1.25326,1.23181,533.80,61816.41
2004.02.27 15:00,s/l,1554,2.00,1.24642,1.24642,1.23088,-1604.00,60212.41
2004.03.01 16:00,s/l,1555,1.91,1.24502,1.24502,1.26072,-1199.48,59012.93
2004.03.03 17:00,t/p,1556,1.66,1.20988,1.22774,1.20988,1892.57,60905.50
2004.03.04 09:00,s/l,1557,1.55,1.22302,1.22302,1.20141,-1205.43,59700.07
2004.03.05 20:00,s/l,1558,1.87,1.23575,1.23575,1.25263,532.95,60233.02
2004.03.09 00:00,close,1559,1.46,1.24240,1.23189,1.25516,318.86,60551.88
2004.03.15 10:00,s/l,1560,1.51,1.23050,1.23050,1.20811,-1208.00,59343.88
2004.03.18 19:00,s/l,1561,1.83,1.23662,1.23662,1.25283,-1185.84,58158.04
2004.03.19 17:00,s/l,1562,1.47,1.23152,1.23152,1.25386,-1174.24,56983.80
2004.03.25 12:00,close,1563,1.45,1.21280,1.22172,1.19983,159.50,57143.30
2004.04.05 13:00,t/p,1564,1.95,1.20388,1.21892,1.20388,2535.20,59678.50
2004.04.13 15:00,t/p,1565,2.24,1.19167,1.20522,1.19167,1955.52,61634.02
2004.04.15 16:00,close,1566,1.75,1.19150,1.19934,1.17963,126.70,61760.72
2004.04.21 23:00,t/p,1567,1.91,1.17976,1.19787,1.17976,2219.61,63980.33
2004.05.04 09:00,t/p,1568,2.58,1.20169,1.18904,1.20169,2184.23,66164.56
2004.05.05 01:00,t/p,1569,2.81,1.21288,1.20075,1.21288,2661.63,68826.19
2004.05.05 16:00,close,1570,2.34,1.21640,1.20533,1.22176,1216.80,70042.99
2004.05.07 13:00,s/l,1571,2.90,1.21257,1.21257,1.20040,-1417.81,68625.18
2004.05.07 13:00,s/l,1572,2.42,1.21013,1.21013,1.19380,-1193.06,67432.12
2004.05.11 12:00,t/p,1573,2.67,1.18032,1.19362,1.18032,3829.31,71261.43
2004.05.11 15:00,close,1574,2.14,1.18060,1.19070,1.17249,1065.93,72327.37
2004.05.14 16:00,s/l,1575,2.89,1.18411,1.18411,1.19659,-1442.11,70885.26
2004.05.17 08:00,t/p,1576,2.78,1.20273,1.19001,1.20273,2121.14,73006.40
2004.05.20 21:00,s/l,1577,2.83,1.19696,1.19696,1.18407,-1460.28,71546.12
2004.05.21 05:00,s/l,1578,2.36,1.19807,1.19807,1.18080,-1460.60,70085.51
2004.05.26 06:00,close,1579,2.32,1.21080,1.20088,1.21773,902.94,70988.46
2004.05.28 15:00,s/l,1580,2.56,1.22106,1.22106,1.23657,-1418.24,69570.22
2004.06.01 07:00,s/l,1581,2.99,1.22564,1.22564,1.21403,-1398.72,68171.50
2004.06.08 02:00,s/l,1582,3.15,1.22869,1.22869,1.23921,212.31,68383.81
2004.06.09 19:00,t/p,1583,2.54,1.20583,1.22087,1.20583,2456.18,70839.99
2004.06.10 12:00,close,1584,2.58,1.20490,1.21129,1.19592,232.20,71072.19
2004.06.17 11:00,s/l,1585,2.46,1.20646,1.20646,1.19033,-1416.96,69655.23
2004.06.23 11:00,s/l,1586,2.31,1.20929,1.20929,1.22611,-1388.31,68266.92
2004.06.24 12:00,s/l,1587,2.25,1.21294,1.21294,1.19602,-1359.00,66907.92
2004.06.25 08:00,s/l,1588,2.67,1.21310,1.21310,1.22560,-1337.14,65570.78
2004.07.07 06:00,t/p,1589,3.09,1.23650,1.22567,1.23650,2928.08,68498.86
2004.07.15 08:00,s/l,1590,2.79,1.23420,1.23420,1.24793,-1373.80,67125.07
2004.07.19 11:00,s/l,1591,4.11,1.24094,1.24094,1.24909,-1877.45,65247.62
2004.07.20 20:00,t/p,1592,3.89,1.23042,1.23888,1.23042,2598.52,67846.14
2004.07.21 15:00,t/p,1593,3.10,1.22463,1.23687,1.22463,2439.70,70285.84
2004.07.23 19:00,t/p,1594,3.19,1.20906,1.22157,1.20906,2883.76,73169.60
2004.07.27 14:00,s/l,1595,3.72,1.21497,1.21497,1.22479,-1461.96,71707.64
2004.07.29 14:00,t/p,1596,3.39,1.19929,1.20998,1.19929,2316.73,74024.37
2004.08.10 11:00,close,1598,2.77,1.22810,1.22086,1.23582,524.08,74548.45
2004.08.10 19:00,s/l,1597,3.57,1.22693,1.22693,1.23635,504.80,75053.25
2004.08.12 19:00,close,1599,3.07,1.22570,1.22112,1.23479,-92.10,74961.15
2004.08.17 14:00,s/l,1600,3.81,1.23140,1.23140,1.24139,-425.20,74535.95
2004.08.23 12:00,t/p,1601,4.72,1.22545,1.23370,1.22545,3318.63,77854.58
2004.09.07 09:00,s/l,1602,3.84,1.20948,1.20948,1.19903,108.29,77962.87
2004.09.09 22:00,close,1603,3.21,1.22340,1.21375,1.22732,1540.80,79503.67
2004.09.10 11:00,s/l,1604,4.58,1.22046,1.22046,1.22930,-1441.78,78061.89
2004.09.16 14:00,close,1606,3.27,1.21270,1.21926,1.20593,569.96,78631.85
2004.09.16 17:00,s/l,1605,4.21,1.21794,1.21794,1.20858,-1472.24,77159.61
2004.09.20 03:00,s/l,1607,4.05,1.21529,1.21529,1.22481,-1185.03,75974.58
2004.09.21 19:00,t/p,1608,4.15,1.23159,1.22244,1.23159,2278.35,78252.93
2004.09.23 20:00,s/l,1609,3.26,1.22620,1.22620,1.23963,-1564.80,76688.13
2004.09.28 16:00,s/l,1610,4.05,1.22992,1.22992,1.23938,-1530.90,75157.23
2004.10.04 01:00,s/l,1611,4.17,1.23689,1.23689,1.24592,-1845.64,73311.59
2004.10.08 13:00,s/l,1612,4.98,1.23028,1.23028,1.23782,-956.16,72355.43
2004.10.12 06:00,s/l,1613,3.21,1.23539,1.23539,1.24801,-1450.28,70905.15
2004.10.13 12:00,close,1614,3.27,1.22680,1.23573,1.22360,1497.99,72403.14
2004.10.13 18:00,s/l,1615,4.08,1.22858,1.22858,1.21939,-807.84,71595.30
2004.10.20 08:00,t/p,1616,3.86,1.25398,1.24452,1.25398,3457.02,75052.31
2004.10.21 09:00,t/p,1617,4.05,1.26406,1.25480,1.26406,2404.08,77456.39
2004.10.26 03:00,t/p,1618,3.91,1.28333,1.27328,1.28333,2706.50,80162.90
2004.10.27 11:00,s/l,1619,3.78,1.27783,1.27783,1.26725,-1606.12,78556.77
2004.11.04 11:00,close,1621,3.09,1.28450,1.27697,1.29134,741.60,79298.37
2004.11.04 12:00,t/p,1620,3.62,1.28590,1.27507,1.28590,2344.31,81642.69
2004.11.05 15:00,s/l,1622,3.74,1.28746,1.28746,1.27657,-1630.64,80012.05
2004.11.09 01:00,s/l,1623,3.49,1.29022,1.29022,1.30168,-1604.00,78408.04
2004.11.10 15:00,s/l,1624,3.67,1.29171,1.29171,1.30243,-1647.83,76760.21
2004.11.15 18:00,s/l,1625,3.61,1.29276,1.29276,1.30286,-1389.13,75371.08
2004.11.18 08:00,close,1627,2.93,1.30550,1.29767,1.31204,784.07,76155.15
2004.11.18 13:00,s/l,1626,3.86,1.30005,1.30005,1.30992,-954.96,75200.19
2004.11.23 11:00,s/l,1628,4.00,1.30196,1.30196,1.29257,-1504.00,73696.19
2004.11.26 01:00,t/p,1629,3.03,1.32603,1.31245,1.32603,2642.77,76338.95
2004.12.03 19:00,t/p,1630,3.66,1.34345,1.33303,1.34345,2287.50,78626.45
2004.12.07 17:00,close,1631,2.94,1.34370,1.33706,1.35201,379.85,79006.30
2004.12.08 14:00,t/p,1632,2.84,1.32289,1.33846,1.32289,2842.84,81849.14
2004.12.08 18:00,s/l,1633,2.78,1.33107,1.33107,1.31463,-1631.86,80217.28
2004.12.17 10:00,s/l,1635,2.49,1.32992,1.32992,1.31139,-1653.11,78564.17
2004.12.20 09:00,s/l,1634,2.94,1.33388,1.33388,1.32017,-857.89,77706.28
2004.12.24 13:00,close,1636,2.45,1.35330,1.34267,1.36040,1051.54,78757.82
2004.12.28 05:00,s/l,1637,3.55,1.35899,1.35899,1.37026,-1177.89,77579.93
2004.12.31 20:00,s/l,1638,4.26,1.35684,1.35684,1.34774,-1550.64,76029.29
2005.01.04 16:00,t/p,1639,3.71,1.33226,1.34250,1.33226,1573.04,77602.33
2005.01.06 09:00,close,1640,2.79,1.31890,1.33206,1.31650,2104.50,79706.83
2005.01.07 14:00,s/l,1641,3.45,1.31855,1.31855,1.33018,-1638.75,78068.08
2005.01.10 04:00,s/l,1642,3.04,1.30842,1.30842,1.29537,-1045.46,77022.62
2005.01.13 09:00,s/l,1643,2.83,1.32306,1.32306,1.33692,-980.31,76042.31
2005.01.14 02:00,s/l,1644,2.64,1.31901,1.31901,1.33522,-1530.67,74511.64
2005.01.17 19:00,close,1645,2.37,1.30740,1.31768,1.30010,943.50,75455.13
2005.01.26 05:00,s/l,1646,3.17,1.29996,1.29996,1.28807,-1388.14,74066.99
2005.01.28 14:00,close,1647,2.44,1.30730,1.30103,1.31802,40.99,74107.98
2005.02.04 14:00,s/l,1648,3.71,1.29960,1.29960,1.28961,-1862.05,72245.93
2005.02.07 18:00,t/p,1649,3.66,1.27643,1.28671,1.27643,5911.27,78157.20
2005.02.07 18:00,t/p,1650,2.89,1.27412,1.28871,1.27412,2710.82,80868.02
2005.02.10 15:00,s/l,1651,2.93,1.28252,1.28252,1.26707,-1645.19,79222.82
2005.02.14 02:00,t/p,1652,3.83,1.29463,1.28424,1.29463,2035.26,81258.09
2005.02.15 11:00,t/p,1653,4.08,1.29947,1.28952,1.29947,2228.50,83486.58
2005.02.15 15:00,s/l,1654,3.88,1.29960,1.29960,1.31034,-1668.40,81818.18
2005.02.22 16:00,t/p,1655,4.79,1.32261,1.31343,1.32261,5561.19,87379.37
2005.02.28 16:00,s/l,1656,4.72,1.32380,1.32380,1.33305,-1746.40,85632.97
2005.03.07 13:00,s/l,1657,4.51,1.32006,1.32006,1.32992,-607.95,85025.02
2005.03.09 17:00,close,1659,3.76,1.33800,1.33275,1.34577,225.60,85250.62
2005.03.09 18:00,t/p,1658,4.66,1.34019,1.33088,1.34019,3859.41,89110.04
2005.03.14 07:00,s/l,1660,4.80,1.34319,1.34319,1.35247,-1784.64,87325.40
2005.03.16 08:00,s/l,1661,4.22,1.33456,1.33456,1.32416,-1425.94,85899.46
2005.03.21 03:00,t/p,1662,4.24,1.32583,1.33595,1.32583,2565.62,88465.08
2005.03.23 14:00,t/p,1663,3.78,1.30139,1.31308,1.30139,2642.60,91107.68
2005.03.24 11:00,close,1664,3.19,1.29830,1.30712,1.29110,2023.42,93131.10
2005.03.29 03:00,s/l,1665,4.13,1.29400,1.29400,1.28275,-1866.35,91264.75
2005.04.01 15:00,s/l,1666,4.45,1.29690,1.29690,1.30715,-1824.50,89440.25
2005.04.04 15:00,t/p,1667,4.06,1.28270,1.29370,1.28270,2306.49,91746.74
2005.04.05 12:00,close,1668,3.27,1.28080,1.29050,1.27483,1334.49,93081.22
2005.04.08 16:00,s/l,1669,3.80,1.28850,1.28850,1.27479,-1862.00,91219.22
2005.04.12 14:00,s/l,1670,3.69,1.29147,1.29147,1.30528,-1822.12,89397.10
2005.04.12 19:00,s/l,1671,4.42,1.29238,1.29238,1.28219,-1228.76,88168.34
2005.04.15 12:00,s/l,1672,3.51,1.28582,1.28582,1.27177,-1768.69,86399.65
2005.04.19 08:00,close,1673,3.07,1.30330,1.29727,1.31248,-125.26,86274.40
2005.04.27 13:00,s/l,1674,3.93,1.29499,1.29499,1.28402,-1725.27,84549.13
2005.05.04 02:00,s/l,1675,3.27,1.29066,1.29066,1.27621,-1699.75,82849.38
2005.05.09 03:00,t/p,1676,5.21,1.27981,1.28796,1.27981,3215.09,86064.47
2005.05.09 22:00,s/l,1677,4.07,1.28682,1.28682,1.27500,-1717.54,84346.93
2005.05.12 07:00,t/p,1678,4.84,1.27637,1.28526,1.27637,1777.73,86124.66
2005.05.18 05:00,close,1679,3.92,1.26070,1.26913,1.25645,2055.26,88179.92
2005.05.20 22:00,s/l,1680,4.81,1.25810,1.25810,1.24859,0.00,88179.92
2005.05.24 11:00,s/l,1681,3.82,1.26062,1.26062,1.24769,-1772.10,86407.82
2005.05.30 12:00,s/l,1682,3.93,1.24971,1.24971,1.26200,-1725.27,84682.55
2005.06.06 14:00,s/l,1683,3.78,1.22879,1.22879,1.21781,-2347.00,82335.55
2005.06.13 10:00,t/p,1684,3.54,1.20546,1.21752,1.20546,3866.03,86201.58
2005.06.13 22:00,s/l,1685,3.12,1.21207,1.21207,1.19647,-427.44,85774.14
2005.06.16 04:00,s/l,1686,4.02,1.20664,1.20664,1.21730,-1722.17,84051.98
2005.06.29 08:00,t/p,1687,3.74,1.20276,1.21432,1.20276,3785.25,87837.23
2005.07.07 10:00,s/l,1688,3.07,1.19781,1.19781,1.18182,-1782.14,86055.09
2005.07.07 13:00,s/l,1689,4.25,1.19565,1.19565,1.20577,-1338.75,84716.34
2005.07.11 15:00,t/p,1690,4.41,1.20566,1.19606,1.20566,2540.16,87256.50
2005.07.12 05:00,t/p,1691,3.46,1.21585,1.20177,1.21585,3128.53,90385.04
2005.07.13 09:00,s/l,1692,3.31,1.21774,1.21774,1.23274,374.69,90759.73
2005.07.15 07:00,s/l,1693,3.26,1.21346,1.21346,1.19789,-1818.75,88940.97
2005.07.18 09:00,s/l,1694,3.94,1.20830,1.20830,1.19704,-1780.49,87160.49
2005.07.19 17:00,s/l,1696,3.26,1.20272,1.20272,1.18754,-1766.92,85393.57
2005.07.19 18:00,s/l,1695,3.95,1.20380,1.20380,1.19255,-1185.00,84208.57
2005.07.26 05:00,close,1698,2.89,1.20440,1.21240,1.19615,630.31,84838.88
2005.07.26 13:00,t/p,1697,3.24,1.19872,1.21169,1.19872,2508.41,87347.29
2005.07.29 09:00,s/l,1699,3.86,1.20908,1.20908,1.22038,-1747.81,85599.48
2005.08.04 02:00,t/p,1700,3.85,1.23725,1.22616,1.23725,2551.01,88150.49
2005.08.05 13:00,s/l,1702,4.11,1.23434,1.23434,1.24524,-1630.85,86519.64
2005.08.09 00:00,close,1701,3.18,1.23650,1.22746,1.24298,1105.37,87625.01
2005.08.19 08:00,t/p,1703,4.82,1.21315,1.22223,1.21315,2617.74,90242.75
2005.08.22 12:00,s/l,1704,3.67,1.22336,1.22336,1.21003,-1753.89,88488.86
2005.08.31 01:00,s/l,1706,4.10,1.22305,1.22305,1.21060,-643.29,87845.57
2005.08.31 15:00,s/l,1705,5.02,1.22622,1.22622,1.21718,-1083.32,86762.25
2005.09.01 12:00,t/p,1707,4.82,1.23924,1.22967,1.23924,4538.51,91300.76
2005.09.01 15:00,t/p,1708,3.90,1.24457,1.23170,1.24457,3225.30,94526.06
2005.09.02 09:00,t/p,1709,3.96,1.25639,1.24303,1.25639,3401.64,97927.70
2005.09.13 10:00,t/p,1710,4.43,1.22668,1.23772,1.22668,2924.24,100851.95
2005.09.15 02:00,close,1711,3.77,1.22400,1.23351,1.21865,1547.59,102399.53
2005.09.16 03:00,s/l,1712,5.48,1.22583,1.22583,1.21650,-2054.45,100345.08
2005.09.16 11:00,s/l,1713,5.50,1.22535,1.22535,1.23447,-2227.50,98117.58
2005.09.23 13:00,t/p,1714,4.79,1.20886,1.21909,1.20886,2596.66,100714.24
2005.09.27 07:00,t/p,1715,4.89,1.19983,1.21012,1.19983,2998.55,103712.79
2005.10.05 15:00,s/l,1716,5.51,1.19826,1.19826,1.18886,-2423.30,101289.49
2005.10.07 13:00,s/l,1717,3.91,1.21276,1.21276,1.22604,-2091.07,99198.42
2005.10.13 08:00,close,1718,3.97,1.19770,1.20869,1.19472,2351.83,101550.25
2005.10.19 07:00,close,1719,3.94,1.18840,1.19955,1.18513,2356.51,103906.76
2005.10.27 04:00,close,1720,3.66,1.21100,1.20371,1.21964,357.22,104263.98
2005.10.31 16:00,t/p,1721,4.63,1.19925,1.21084,1.19925,5199.95,109463.93
2005.11.02 16:00,s/l,1722,3.81,1.20504,1.20504,1.18896,-2201.42,107262.51
2005.11.03 20:00,t/p,1723,4.72,1.19368,1.20504,1.19368,3219.04,110481.55
2005.11.04 16:00,t/p,1724,4.08,1.18526,1.20041,1.18526,3729.12,114210.67
2005.11.08 02:00,t/p,1725,4.62,1.17450,1.18684,1.17450,3124.04,117334.72
2005.11.08 15:00,s/l,1726,5.37,1.17597,1.17597,1.16505,-2346.69,114988.03
2005.11.11 21:00,s/l,1727,5.37,1.17248,1.17248,1.16178,-2308.56,112679.46
2005.11.14 12:00,s/l,1728,6.15,1.17292,1.17292,1.18236,-848.70,111830.76
2005.11.18 04:00,s/l,1729,5.94,1.17220,1.17220,1.18194,-242.35,111588.41
2005.11.22 20:00,s/l,1730,4.42,1.17614,1.17614,1.16203,-2227.68,109360.73
2005.11.23 12:00,s/l,1731,5.35,1.17671,1.17671,1.18693,-2245.93,107114.80
2005.11.29 14:00,s/l,1732,4.16,1.17666,1.17666,1.19106,-2138.24,104976.56
2005.12.02 15:00,close,1734,3.99,1.16650,1.17639,1.16157,1827.82,106804.38
2005.12.05 13:00,s/l,1733,4.70,1.17520,1.17520,1.16394,-1192.86,105611.52
2005.12.08 16:00,t/p,1735,5.06,1.18300,1.17250,1.18300,3390.20,109001.72
2005.12.12 05:00,close,1736,3.96,1.18400,1.17452,1.18902,983.66,109985.38
2005.12.13 10:00,s/l,1737,4.03,1.19121,1.19121,1.20546,-1530.59,108454.79
2005.12.21 08:00,s/l,1738,5.22,1.18881,1.18881,1.17779,1185.46,109640.25
2005.12.21 15:00,close,1739,4.38,1.18090,1.19243,1.17834,2847.00,112487.25
2005.12.22 15:00,s/l,1740,5.02,1.18578,1.18578,1.17458,-2277.57,110209.68
2005.12.23 13:00,s/l,1741,5.30,1.18405,1.18405,1.19468,-1408.74,108800.94
2005.12.28 17:00,s/l,1742,6.11,1.18792,1.18792,1.19687,-2737.28,106063.66
2006.01.06 14:00,t/p,1743,4.51,1.21705,1.20375,1.21705,4743.62,110807.28
2006.01.09 08:00,s/l,1744,6.00,1.21171,1.21171,1.22093,-2638.80,108168.48
2006.01.12 14:00,s/l,1745,5.75,1.20754,1.20754,1.21693,-2175.80,105992.68
2006.01.13 10:00,s/l,1746,5.03,1.20794,1.20794,1.19734,-2544.68,103448.00
2006.01.17 01:00,s/l,1747,4.67,1.20937,1.20937,1.22044,-2076.28,101371.72
2006.01.23 18:00,t/p,1748,5.26,1.22987,1.22025,1.22987,2561.62,103933.34
2006.01.25 03:00,s/l,1749,3.80,1.22516,1.22516,1.23815,1004.72,104938.06
2006.01.27 16:00,t/p,1750,5.83,1.21577,1.22482,1.21577,3154.61,108092.67
2006.01.30 14:00,t/p,1751,5.94,1.20745,1.21654,1.20745,3226.01,111318.68
2006.01.31 20:00,s/l,1752,5.85,1.21370,1.21370,1.22320,-2223.00,109095.68
2006.02.03 17:00,s/l,1753,5.76,1.20179,1.20179,1.19232,-2183.04,106912.64
2006.02.06 01:00,s/l,1754,4.52,1.20477,1.20477,1.19141,-2164.63,104748.02
2006.02.14 14:00,t/p,1755,5.85,1.18633,1.19528,1.18633,3119.22,107867.24
2006.02.20 09:00,s/l,1756,7.88,1.19366,1.19366,1.20050,-2159.12,105708.12
2006.02.22 17:00,s/l,1757,8.11,1.19030,1.19030,1.18379,-2108.60,103599.52
2006.02.23 15:00,s/l,1758,7.57,1.19356,1.19356,1.20040,-2074.18,101525.34
2006.02.28 16:00,t/p,1759,8.00,1.19270,1.18636,1.19270,3040.00,104565.34
2006.03.06 00:00,t/p,1760,7.24,1.20600,1.19867,1.20600,3970.42,108535.75
2006.03.06 00:00,t/p,1761,6.10,1.20739,1.19776,1.20739,3771.02,112306.77
2006.03.06 10:00,s/l,1762,7.74,1.20410,1.20410,1.21135,-2244.60,110062.17
2006.03.17 18:00,t/p,1763,6.67,1.22025,1.21184,1.22025,4430.21,114492.39
2006.03.24 16:00,s/l,1764,7.06,1.20146,1.20146,1.19332,-2314.97,112177.41
2006.03.24 16:00,s/l,1765,5.54,1.20116,1.20116,1.18952,-2315.17,109862.25
2006.03.27 17:00,s/l,1766,6.75,1.20059,1.20059,1.20887,-484.65,109377.60
2006.04.06 09:00,t/p,1767,5.39,1.23278,1.22265,1.23278,3259.87,112637.47
2006.04.07 14:00,t/p,1768,5.52,1.21558,1.22578,1.21558,3367.75,116005.22
2006.04.07 17:00,t/p,1769,4.93,1.21023,1.22325,1.21023,5161.71,121166.93
2006.04.11 07:00,s/l,1771,4.99,1.21379,1.21379,1.20009,-2449.59,118717.34
2006.04.11 20:00,s/l,1770,5.74,1.21503,1.21503,1.20445,-2335.03,116382.31
2006.04.17 12:00,t/p,1772,6.83,1.22331,1.21480,1.22331,2943.73,119326.04
2006.04.18 17:00,close,1773,4.83,1.22880,1.22076,1.23459,1493.44,120819.47
2006.04.27 16:00,s/l,1774,5.96,1.25015,1.25015,1.26028,-2413.80,118405.67
2006.05.01 20:00,s/l,1775,5.84,1.25889,1.25889,1.26941,3839.22,122244.89
2006.05.04 13:00,s/l,1776,6.29,1.26208,1.26208,1.25237,-2440.52,119804.37
2006.05.08 15:00,s/l,1777,5.69,1.27069,1.27069,1.28121,-2400.04,117404.33
2006.05.09 14:00,s/l,1778,4.74,1.27445,1.27445,1.26059,-2346.30,115058.03
2006.05.10 18:00,close,1780,4.61,1.27910,1.27288,1.28693,553.20,115611.23
2006.05.10 19:00,t/p,1779,5.18,1.28276,1.27166,1.28276,3445.74,119056.96
2006.05.12 13:00,s/l,1781,4.32,1.28660,1.28660,1.30201,-2376.00,116680.96
2006.05.18 09:00,s/l,1782,4.54,1.27734,1.27734,1.26450,-2359.44,114321.53
2006.05.23 22:00,s/l,1783,3.58,1.28022,1.28022,1.29808,-2284.04,112037.49
2006.05.24 08:00,s/l,1784,4.09,1.28336,1.28336,1.26947,-2036.41,110001.07
2006.05.30 15:00,t/p,1785,4.26,1.28822,1.27519,1.28822,3288.72,113289.79
2006.06.06 04:00,s/l,1786,4.71,1.28839,1.28839,1.30041,-1802.05,111487.75
2006.06.06 13:00,s/l,1787,3.41,1.28478,1.28478,1.30331,-2262.88,109224.87
2006.06.07 12:00,close,1788,3.39,1.27810,1.28903,1.27102,1519.06,110743.93
2006.06.09 13:00,close,1790,3.67,1.26060,1.27023,1.25447,1717.93,112461.86
2006.06.12 13:00,t/p,1789,4.97,1.25738,1.26874,1.25738,5507.75,117969.61
2006.06.23 09:00,close,1791,4.77,1.25510,1.26204,1.24821,944.94,118914.55
2006.06.23 17:00,s/l,1792,6.71,1.25312,1.25312,1.24407,-1758.02,117156.53
2006.06.30 06:00,t/p,1793,6.36,1.27213,1.26292,1.27213,3702.79,120859.32
2006.07.04 05:00,close,1794,5.12,1.28070,1.27389,1.28708,1067.01,121926.33
2006.07.10 01:00,s/l,1795,6.80,1.27872,1.27872,1.28768,-2303.84,119622.49
2006.07.14 01:00,close,1796,5.10,1.26790,1.27528,1.26217,1338.24,120960.73
2006.07.18 15:00,close,1797,5.40,1.24940,1.25668,1.24414,1501.74,122462.47
2006.07.21 01:00,close,1799,5.65,1.26350,1.25588,1.26826,1803.48,124265.95
2006.07.21 08:00,t/p,1798,6.76,1.26641,1.25706,1.26641,6677.53,130943.48
2006.07.25 15:00,s/l,1800,7.49,1.26251,1.26251,1.27124,-2614.01,128329.47
2006.07.27 14:00,t/p,1801,7.24,1.27567,1.26606,1.27567,9300.50,137629.97
2006.07.27 19:00,s/l,1802,5.85,1.26905,1.26905,1.28207,-2720.25,134909.72
2006.08.04 22:00,s/l,1803,7.26,1.28557,1.28557,1.29515,-1618.98,133290.74
2006.08.15 02:00,t/p,1804,6.74,1.27019,1.28021,1.27019,4753.72,138044.46
2006.08.16 13:00,close,1806,6.10,1.28420,1.27411,1.28669,3416.00,141460.46
2006.08.17 19:00,s/l,1805,7.05,1.28114,1.28114,1.29130,922.14,142382.60
2006.08.21 15:00,t/p,1807,7.67,1.29366,1.28439,1.29366,4801.42,147184.02
2006.08.23 15:00,s/l,1808,6.16,1.28442,1.28442,1.27092,-1933.62,145250.40
2006.09.01 15:00,s/l,1809,9.60,1.28022,1.28022,1.27266,-2899.20,142351.20
2006.09.05 03:00,s/l,1810,9.79,1.28339,1.28339,1.29066,-2856.72,139494.48
2006.09.05 08:00,s/l,1811,7.11,1.28240,1.28240,1.29360,-2849.69,136644.79
2006.09.06 19:00,s/l,1812,10.09,1.28084,1.28084,1.27398,-1957.46,134687.33
2006.09.11 09:00,s/l,1813,9.17,1.27054,1.27054,1.26319,-3171.90,131515.43
2006.09.14 13:00,s/l,1814,9.05,1.27000,1.27000,1.27726,-2624.50,128890.93
2006.09.14 19:00,s/l,1815,8.67,1.27223,1.27223,1.27966,-2574.99,126315.94
2006.09.18 14:00,s/l,1816,6.76,1.26864,1.26864,1.25817,-2541.08,123774.85
2006.09.21 17:00,t/p,1817,8.00,1.27474,1.26701,1.27474,3692.80,127467.65
2006.09.28 01:00,s/l,1818,8.30,1.27249,1.27249,1.26477,-2378.78,125088.87
2006.09.28 01:00,s/l,1819,6.33,1.27265,1.27265,1.26132,-2611.76,122477.11
2006.10.03 13:00,s/l,1821,6.75,1.27186,1.27186,1.28206,-2457.00,120020.11
2006.10.04 02:00,s/l,1820,7.96,1.27152,1.27152,1.27921,-2464.42,117555.70
2006.10.04 19:00,s/l,1822,7.99,1.27050,1.27050,1.26300,-1598.00,115957.70
2006.10.06 22:00,s/l,1823,7.66,1.26152,1.26152,1.25373,-1394.12,114563.58
2006.10.10 09:00,close,1824,5.98,1.25640,1.26396,1.25315,2189.88,116753.45
2006.10.11 16:00,s/l,1825,8.64,1.25572,1.25572,1.24867,398.30,117151.76
2006.10.18 20:00,s/l,1826,8.66,1.25370,1.25370,1.24694,-1905.20,115246.56
2006.10.25 19:00,t/p,1827,9.06,1.26102,1.25466,1.26102,3453.67,118700.23
2006.10.27 02:00,t/p,1828,6.80,1.27108,1.26131,1.27108,4264.96,122965.19
2006.10.31 15:00,s/l,1829,9.05,1.27152,1.27152,1.26473,-2461.60,120503.59
2006.11.02 01:00,s/l,1830,8.19,1.27416,1.27416,1.28151,-2434.07,118069.52
2006.11.02 19:00,close,1831,7.07,1.27830,1.27126,1.28062,2598.93,120668.45
2006.11.06 18:00,s/l,1832,8.25,1.27244,1.27244,1.26509,-3101.18,117567.28
2006.11.10 09:00,t/p,1833,8.01,1.28790,1.28057,1.28790,3517.99,121085.27
2006.11.10 20:00,s/l,1834,6.61,1.28424,1.28424,1.29449,-2419.26,118666.01
2006.11.22 13:00,t/p,1835,8.67,1.28900,1.28216,1.28900,3634.46,122300.48
2006.11.27 00:00,t/p,1836,7.97,1.31273,1.30484,1.31273,4560.43,126860.91
2006.11.27 19:00,close,1837,6.55,1.31240,1.30603,1.31687,1637.50,128498.41
2006.12.01 16:00,t/p,1838,6.34,1.33170,1.32035,1.33170,4623.13,133121.54
2006.12.06 10:00,s/l,1839,7.21,1.32771,1.32771,1.33694,-4480.29,128641.24
2006.12.06 16:00,s/l,1840,7.02,1.33176,1.33176,1.32260,-2920.32,125720.92
2006.12.08 17:00,s/l,1841,7.32,1.33077,1.33077,1.33935,-2510.76,123210.16
2006.12.11 01:00,t/p,1842,6.71,1.31699,1.32617,1.31699,3684.46,126894.62
2006.12.11 08:00,s/l,1843,6.87,1.31931,1.31931,1.31003,-3579.27,123315.35
2006.12.15 18:00,close,1844,5.51,1.30770,1.31917,1.30665,3857.00,127172.35
2006.12.19 14:00,s/l,1845,6.49,1.31298,1.31298,1.32277,-2024.88,125147.47
2006.12.20 04:00,t/p,1846,5.15,1.32424,1.31065,1.32424,4496.98,129644.45
2007.01.03 11:00,s/l,1847,5.79,1.32373,1.32373,1.33681,475.94,130120.39
2007.01.03 14:00,s/l,1848,7.35,1.32574,1.32574,1.31689,-2454.90,127665.49
2007.01.04 17:00,t/p,1849,5.39,1.30789,1.32113,1.30789,4556.17,132221.66
2007.01.08 18:00,s/l,1850,7.03,1.30308,1.30308,1.29362,-1827.10,130394.56
2007.01.24 09:00,s/l,1851,8.40,1.29947,1.29947,1.30730,-1207.92,129186.64
2007.01.31 13:00,s/l,1852,9.00,1.29600,1.29600,1.28876,-1890.00,127296.64
2007.02.02 14:00,t/p,1853,8.27,1.30461,1.29692,1.30461,3786.01,131082.65
2007.02.02 15:00,s/l,1854,9.20,1.30155,1.30155,1.30867,-2622.00,128460.65
2007.02.06 19:00,s/l,1855,8.59,1.29800,1.29800,1.29026,225.06,128685.71
2007.02.08 09:00,s/l,1856,9.13,1.29898,1.29898,1.30602,-2596.57,126089.13
2007.02.14 09:00,t/p,1857,7.29,1.30912,1.29944,1.30912,4534.38,130623.51
2007.02.14 16:00,t/p,1858,8.88,1.31421,1.30686,1.31421,3916.08,134539.59
2007.02.22 17:00,s/l,1859,9.82,1.31224,1.31224,1.30539,-3181.68,131357.91
2007.02.27 09:00,t/p,1860,9.45,1.32085,1.31377,1.32085,4190.13,135548.04
2007.03.01 21:00,s/l,1861,10.79,1.31974,1.31974,1.31340,-3495.96,132052.08
2007.03.08 09:00,s/l,1862,8.89,1.31523,1.31523,1.32265,-2661.67,129390.42
2007.03.13 13:00,close,1863,7.46,1.32030,1.31543,1.32514,1044.40,130434.82
2007.03.15 10:00,s/l,1864,8.71,1.32014,1.32014,1.32778,-2163.56,128271.25
2007.03.19 11:00,s/l,1866,6.93,1.32804,1.32804,1.33857,-2611.22,125660.03
2007.03.20 11:00,s/l,1865,8.98,1.32741,1.32741,1.33464,-1531.99,124128.04
2007.03.22 10:00,s/l,1867,8.69,1.33583,1.33583,1.34301,-1993.49,122134.56
2007.03.27 15:00,close,1868,6.88,1.33460,1.32915,1.33908,1307.20,123441.76
2007.04.04 11:00,s/l,1869,8.56,1.33602,1.33602,1.32872,-2601.38,120840.37
2007.04.06 13:00,s/l,1870,8.87,1.34068,1.34068,1.34749,-2331.04,118509.34
2007.04.10 02:00,s/l,1871,8.57,1.33978,1.33978,1.33282,-2157.93,116351.41
2007.04.10 02:00,s/l,1872,7.03,1.33983,1.33983,1.33022,-2494.95,113856.46
2007.04.12 02:00,t/p,1873,8.39,1.34657,1.33979,1.34657,3387.88,117244.35
2007.04.13 01:00,t/p,1874,8.92,1.35025,1.34367,1.35025,3962.26,121206.61
2007.04.16 19:00,close,1875,7.13,1.35470,1.34810,1.35761,2275.90,123482.51
2007.04.17 17:00,s/l,1876,9.31,1.35555,1.35555,1.36218,-2467.15,121015.36
2007.04.25 11:00,t/p,1877,10.03,1.36572,1.35969,1.36572,3522.54,124537.89
2007.04.25 15:00,close,1878,7.69,1.36580,1.35935,1.36816,2537.70,127075.59
2007.04.27 11:00,s/l,1879,10.48,1.36267,1.36267,1.35649,-1979.67,125095.92
2007.04.27 16:00,s/l,1880,10.23,1.36349,1.36349,1.37002,-112.53,124983.39
2007.05.03 15:00,t/p,1881,8.80,1.35554,1.36264,1.35554,3681.92,128665.31
2007.05.04 08:00,s/l,1882,7.88,1.35746,1.35746,1.34833,-2568.88,126096.43
2007.05.09 08:00,close,1883,7.45,1.35410,1.35828,1.34882,1177.85,127274.27
2007.05.15 15:00,t/p,1884,7.15,1.35971,1.34974,1.35971,4577.43,131851.70
2007.05.16 13:00,s/l,1885,9.86,1.35759,1.35759,1.36437,-1693.95,130157.76
2007.05.17 07:00,s/l,1886,9.05,1.35424,1.35424,1.34690,-2078.78,128078.97
2007.05.23 11:00,s/l,1887,9.18,1.34549,1.34549,1.33852,-2561.22,125517.75
2007.05.23 18:00,s/l,1888,8.57,1.34597,1.34597,1.35329,-2511.01,123006.74
2007.05.29 05:00,s/l,1889,10.04,1.34477,1.34477,1.33859,-2178.68,120828.06
2007.05.31 15:00,s/l,1890,10.08,1.34420,1.34420,1.35019,-2419.20,118408.86
2007.06.07 17:00,t/p,1891,10.05,1.34357,1.34946,1.34357,3547.65,121956.51
2007.06.08 10:00,t/p,1892,8.11,1.33719,1.34561,1.33719,4387.51,126344.02
2007.06.08 22:00,s/l,1893,7.59,1.33863,1.33863,1.32931,-2527.47,123816.55
2007.06.18 10:00,t/p,1894,9.56,1.34054,1.33397,1.34054,4045.79,127862.34
2007.06.22 10:00,s/l,1895,10.26,1.34269,1.34269,1.33646,-2632.72,125229.63
2007.07.03 11:00,s/l,1896,8.15,1.35889,1.35889,1.36704,-2704.17,122525.46
2007.07.05 14:00,s/l,1897,9.77,1.36216,1.36216,1.36852,-2383.88,120141.58
2007.07.10 06:00,s/l,1898,9.43,1.35985,1.35985,1.36622,-3079.84,117061.74
2007.07.10 08:00,s/l,1899,9.42,1.36288,1.36288,1.35667,-2336.16,114725.58
2007.07.10 14:00,t/p,1900,8.85,1.36959,1.36311,1.36959,3442.65,118168.23
2007.07.10 22:00,t/p,1901,8.35,1.37628,1.36898,1.37628,4492.30,122660.53
2007.07.12 08:00,close,1902,7.24,1.37840,1.37101,1.38050,2878.62,125539.15
2007.07.18 08:00,s/l,1903,9.56,1.37838,1.37838,1.38494,-2504.72,123034.43
2007.07.25 09:00,t/p,1904,11.10,1.37338,1.37892,1.37338,3685.20,126719.63
2007.07.25 15:00,t/p,1905,10.84,1.37049,1.37634,1.37049,2937.64,129657.27
2007.07.27 06:00,s/l,1906,10.22,1.37316,1.37316,1.37950,-2706.26,126951.02
2007.07.30 08:00,s/l,1907,7.04,1.36610,1.36610,1.35601,-2534.40,124416.62
2007.08.03 14:00,t/p,1908,8.06,1.37413,1.36642,1.37413,3725.33,128141.95
2007.08.06 07:00,t/p,1909,8.23,1.38341,1.37522,1.38341,7408.65,135550.60
2007.08.07 14:00,s/l,1910,7.37,1.37762,1.37762,1.38792,-2718.06,132832.54
2007.08.08 12:00,s/l,1911,7.84,1.37789,1.37789,1.36942,-2672.66,130159.88
2007.08.09 07:00,s/l,1912,7.89,1.37850,1.37850,1.38674,-2622.64,127537.25
2007.08.09 15:00,s/l,1913,7.05,1.36992,1.36992,1.36088,-2552.10,124985.15
2007.08.10 11:00,close,1914,5.86,1.36570,1.37270,1.36067,1571.07,126556.21
2007.08.16 04:00,t/p,1915,5.74,1.33929,1.35175,1.33929,6114.82,132671.04
2007.08.17 22:00,s/l,1916,6.41,1.34556,1.34556,1.35590,-2653.74,130017.30
2007.08.21 18:00,s/l,1918,6.33,1.34707,1.34707,1.35740,-2614.29,127403.01
2007.08.22 14:00,close,1917,5.59,1.34870,1.34448,1.35797,-348.82,127054.19
2007.08.23 15:00,close,1919,5.29,1.35720,1.34990,1.36307,1785.90,128840.09
2007.08.24 17:00,t/p,1920,6.86,1.36723,1.35785,1.36723,3862.18,132702.27
2007.08.28 05:00,s/l,1921,5.62,1.36238,1.36238,1.37560,-2657.14,130045.14
2007.09.03 23:00,close,1922,5.74,1.36100,1.36663,1.35395,631.40,130676.54
2007.09.07 03:00,s/l,1923,7.61,1.36627,1.36627,1.37485,-2616.32,128060.22
2007.09.11 11:00,t/p,1924,7.61,1.38169,1.37304,1.38169,4241.81,132302.03
2007.09.11 16:00,close,1925,6.21,1.38380,1.37579,1.38758,2354.83,134656.87
2007.09.18 09:00,s/l,1926,9.32,1.38689,1.38689,1.37967,-2693.48,131963.39
2007.09.19 10:00,s/l,1927,8.02,1.39515,1.39515,1.40352,-1490.12,130473.27
2007.09.20 06:00,close,1928,6.77,1.39780,1.39330,1.40421,389.95,130863.22
2007.09.20 16:00,t/p,1929,8.28,1.40927,1.40115,1.40927,5108.76,135971.98
2007.09.24 06:00,close,1930,6.55,1.41180,1.40245,1.41407,3395.52,139367.50
2007.09.27 09:00,s/l,1931,8.60,1.41274,1.41274,1.42040,-1025.12,138342.38
2007.10.02 08:00,s/l,1932,6.90,1.41809,1.41809,1.42931,-2772.42,135569.96
2007.10.03 16:00,t/p,1933,8.52,1.41313,1.42108,1.41313,4047.85,139617.81
2007.10.09 15:00,s/l,1934,6.38,1.40657,1.40657,1.39433,-2788.06,136829.75
2007.10.10 10:00,t/p,1935,7.32,1.41460,1.40526,1.41460,4093.34,140923.10
2007.10.10 22:00,close,1936,6.13,1.41410,1.41022,1.42304,2574.60,143497.70
2007.10.17 18:00,s/l,1937,7.97,1.41790,1.41790,1.42690,-2869.20,140628.50
2007.10.19 19:00,s/l,1938,7.93,1.42834,1.42834,1.41948,-2807.22,137821.28
2007.10.23 03:00,s/l,1939,7.06,1.42010,1.42010,1.41034,-2766.81,135054.46
2007.10.29 15:00,close,1940,5.81,1.44020,1.43716,1.45016,-929.60,134124.86
2007.11.06 15:00,t/p,1941,8.81,1.45657,1.44896,1.45657,4026.17,138151.03
2007.11.07 21:00,s/l,1942,5.65,1.46212,1.46212,1.47579,-2757.20,135393.83
2007.11.13 07:00,s/l,1943,5.71,1.46030,1.46030,1.44685,-1780.95,133612.88
2007.11.15 11:00,s/l,1944,5.62,1.46085,1.46085,1.47414,-2682.99,130929.90
2007.11.21 07:00,t/p,1945,5.92,1.48518,1.47354,1.48518,7087.42,138017.32
2007.11.21 14:00,close,1946,5.02,1.48400,1.47375,1.48873,2455.78,140473.10
2007.11.23 09:00,s/l,1947,6.60,1.48958,1.48958,1.50062,-1135.20,139337.90
2007.11.28 19:00,s/l,1948,6.36,1.47778,1.47778,1.46683,-2785.68,136552.22
2007.12.04 12:00,s/l,1949,5.86,1.47346,1.47346,1.46181,-3339.03,133213.20
2007.12.05 09:00,s/l,1950,6.20,1.47118,1.47118,1.48222,-1319.36,131893.84
2007.12.10 10:00,s/l,1951,4.70,1.46741,1.46741,1.45171,-2654.56,129239.28
2007.12.11 15:00,s/l,1952,5.56,1.47064,1.47064,1.45903,-2579.84,126659.44
2007.12.13 22:00,s/l,1953,5.45,1.46354,1.46354,1.45194,-1820.30,124839.14
2007.12.14 17:00,t/p,1954,5.12,1.44239,1.45457,1.44239,3742.72,128581.86
2007.12.17 11:00,t/p,1955,4.31,1.43337,1.45006,1.43337,4624.63,133206.49
2007.12.19 17:00,close,1956,4.23,1.43430,1.44488,1.42729,1802.83,135009.31
2007.12.27 18:00,t/p,1957,5.91,1.46382,1.45229,1.46382,4207.92,139217.23
2007.12.28 23:00,t/p,1958,4.89,1.47294,1.45701,1.47294,5003.45,144220.68
2007.12.31 15:00,s/l,1959,5.10,1.46845,1.46845,1.48427,-2881.50,141339.18
2008.01.10 15:00,s/l,1960,5.76,1.47360,1.47360,1.46135,-2855.23,138483.95
2008.01.10 18:00,t/p,1961,5.55,1.48108,1.46862,1.48108,4151.40,142635.35
2008.01.15 10:00,s/l,1962,5.44,1.48340,1.48340,1.49490,1673.34,144308.69
2008.01.15 16:00,s/l,1963,6.68,1.48648,1.48648,1.49728,-2885.76,141422.93
2008.01.17 13:00,s/l,1964,5.67,1.46908,1.46908,1.45662,-2855.98,138566.95
2008.01.21 12:00,t/p,1965,5.66,1.44587,1.45809,1.44587,4092.18,142659.13
2008.01.22 08:00,close,1966,4.66,1.43800,1.44781,1.43070,1724.20,144383.33
2008.01.23 11:00,s/l,1967,4.26,1.45603,1.45603,1.47499,-2884.02,141499.31
2008.01.25 17:00,s/l,1968,3.81,1.46853,1.46853,1.48805,-2658.62,138840.70
2008.01.31 00:00,s/l,1969,4.78,1.48217,1.48217,1.49749,595.59,139436.28
2008.02.06 09:00,t/p,1970,5.98,1.46003,1.47265,1.46003,9957.30,149393.58
2008.02.07 13:00,close,1971,4.26,1.45600,1.47128,1.45202,3554.12,152947.70
2008.02.07 14:00,t/p,1972,6.72,1.44897,1.46035,1.44897,4589.76,157537.46
2008.02.07 19:00,t/p,1973,6.51,1.44445,1.45654,1.44445,3613.05,161150.51
2008.02.13 08:00,s/l,1974,6.54,1.45428,1.45428,1.46659,-2765.11,158385.40
2008.02.14 15:00,s/l,1975,7.00,1.45848,1.45848,1.46979,-3164.00,155221.40
2008.02.20 12:00,s/l,1976,7.75,1.46900,1.46900,1.47901,-3106.20,152115.20
2008.02.20 12:00,s/l,1977,5.57,1.46763,1.46763,1.48323,-3106.95,149008.25
2008.02.20 17:00,s/l,1978,7.17,1.46662,1.46662,1.45608,-1591.74,147416.51
2008.02.26 11:00,t/p,1979,7.68,1.48695,1.47736,1.48695,4397.57,151814.08
2008.02.26 19:00,t/p,1980,8.49,1.49322,1.48418,1.49322,5875.08,157689.16
2008.02.29 01:00,s/l,1981,6.60,1.51721,1.51721,1.52944,-196.68,157492.48
2008.03.06 14:00,t/p,1982,6.18,1.53574,1.52301,1.53574,4706.69,162199.17
2008.03.07 14:00,t/p,1983,5.52,1.54355,1.52730,1.54355,5763.98,167963.15
2008.03.11 13:00,s/l,1984,6.65,1.54286,1.54286,1.55547,-3351.60,164611.55
2008.03.14 15:00,t/p,1985,4.93,1.56485,1.54673,1.56485,9030.77,173642.33
2008.03.17 08:00,s/l,1986,5.69,1.57790,1.57790,1.59314,-3584.70,170057.63
2008.03.24 04:00,close,1987,4.25,1.53500,1.55439,1.53202,3468.85,173526.48
2008.03.24 11:00,s/l,1988,4.88,1.54190,1.54190,1.52414,-3464.80,170061.68
2008.03.26 10:00,t/p,1989,4.88,1.56615,1.54873,1.56615,5095.70,175157.37
2008.03.26 10:00,close,1990,4.12,1.57160,1.55430,1.57810,5641.10,180798.48
2008.03.26 21:00,t/p,1991,5.14,1.58475,1.56717,1.58475,5422.70,186221.18
2008.03.27 11:00,close,1992,4.30,1.58060,1.57164,1.59588,129.00,186350.18
2008.04.02 06:00,t/p,1993,5.71,1.55651,1.57282,1.55651,5579.24,191929.42
2008.04.03 10:00,close,1994,4.25,1.55550,1.57593,1.55149,4940.20,196869.62
2008.04.10 15:00,s/l,1995,7.13,1.57981,1.57981,1.59429,1558.62,198428.23
2008.04.11 07:00,s/l,1996,6.54,1.58078,1.58078,1.56558,-4250.35,194177.89
2008.04.17 12:00,s/l,1997,6.27,1.58831,1.58831,1.60379,-3896.18,190281.71
2008.04.17 12:00,s/l,1998,5.09,1.58726,1.58726,1.60866,-3595.58,186686.13
2008.04.17 13:00,s/l,1999,6.18,1.59124,1.59124,1.57615,-3732.72,182953.41
2008.04.18 19:00,s/l,2000,5.84,1.57899,1.57899,1.56277,-519.76,182433.65
2008.04.24 09:00,t/p,2001,5.36,1.57731,1.59446,1.57731,5645.69,188079.34
2008.04.25 16:00,s/l,2002,4.75,1.56674,1.56674,1.54311,8996.98,197076.32
2008.04.30 20:00,close,2003,5.79,1.56150,1.56450,1.54749,-2211.20,194865.12
2008.05.01 08:00,s/l,2004,6.01,1.55502,1.55502,1.57121,-3908.90,190956.21
2008.05.02 13:00,close,2005,4.62,1.54010,1.55574,1.53351,2578.42,193534.63
2008.05.05 02:00,s/l,2006,6.18,1.54606,1.54606,1.53042,-3818.62,189716.01
2008.05.19 15:00,s/l,2007,6.94,1.55384,1.55384,1.56749,-3794.79,185921.22
2008.05.21 09:00,close,2008,5.15,1.57340,1.55658,1.57680,4939.88,190861.10
2008.05.22 15:00,s/l,2009,6.82,1.57072,1.57072,1.58493,-1980.53,188880.57
2008.06.02 17:00,s/l,2010,5.57,1.55837,1.55837,1.53941,-3792.06,185088.52
2008.06.03 14:00,s/l,2011,7.61,1.55774,1.55774,1.56989,-3698.46,181390.06
2008.06.06 06:00,t/p,2012,7.11,1.56154,1.54864,1.56154,4857.55,186247.61
2008.06.06 15:00,t/p,2013,5.64,1.57207,1.55360,1.57207,6694.68,192942.29
2008.06.09 08:00,t/p,2014,7.02,1.58157,1.56746,1.58157,8818.52,201760.81
2008.06.13 22:00,s/l,2015,5.86,1.53958,1.53958,1.52239,-4031.68,197729.13
2008.06.23 08:00,s/l,2016,5.22,1.55314,1.55314,1.57431,-3946.32,193782.81
2008.06.26 19:00,t/p,2017,6.80,1.57596,1.56169,1.57596,6484.48,200267.29
2008.07.07 03:00,close,2019,6.19,1.56410,1.57707,1.55980,3380.98,203648.27
2008.07.07 17:00,s/l,2018,7.73,1.56854,1.56854,1.55693,6201.01,209849.28
2008.07.11 13:00,t/p,2020,9.19,1.58625,1.57484,1.58625,6287.80,216137.07
2008.07.11 14:00,t/p,2021,9.16,1.59317,1.58138,1.59317,6476.12,222613.19
2008.07.14 09:00,s/l,2022,8.87,1.58598,1.58598,1.59852,-3572.84,219040.36
2008.07.23 15:00,close,2023,6.82,1.56950,1.58482,1.56684,6056.84,225097.20
2008.07.29 15:00,t/p,2024,10.64,1.56036,1.57126,1.56036,11108.16,236205.36
2008.07.31 08:00,s/l,2025,10.12,1.56330,1.56330,1.55156,-4023.71,232181.65
2008.07.31 13:00,s/l,2026,7.95,1.56494,1.56494,1.54830,-4767.61,227414.03
2008.08.05 12:00,t/p,2027,11.10,1.54706,1.55730,1.54706,6815.40,234229.43
2008.08.06 15:00,close,2028,8.24,1.54200,1.55303,1.53698,5587.54,239816.98
2008.08.11 18:00,t/p,2029,7.05,1.49087,1.50990,1.49087,8622.15,248439.13
2008.08.15 09:00,t/p,2030,7.84,1.47060,1.48643,1.47060,7433.10,255872.23
2008.08.25 15:00,close,2031,6.50,1.47810,1.48157,1.45953,-2860.00,253012.23
2008.08.27 01:00,s/l,2032,6.23,1.47012,1.47012,1.44738,-5070.60,247941.63
2008.09.04 22:00,t/p,2033,9.12,1.42724,1.44134,1.42724,9721.92,257663.55
2008.09.08 01:00,s/l,2034,7.10,1.43655,1.43655,1.41624,-5160.99,252502.56
2008.09.08 07:00,s/l,2035,7.83,1.43525,1.43525,1.45137,-5050.35,247452.21
2008.09.15 11:00,s/l,2036,5.11,1.42223,1.42223,1.44931,-4941.37,242510.84
2008.09.18 11:00,t/p,2037,4.80,1.45253,1.42732,1.45253,7250.88,249761.72
2008.09.23 10:00,close,2038,4.06,1.47810,1.46609,1.50084,-531.05,249230.68
2008.09.29 08:00,t/p,2039,5.51,1.43624,1.45884,1.43624,7471.56,256702.24
2008.10.01 20:00,close,2041,4.05,1.40090,1.42100,1.38487,2908.30,259610.54
2008.10.02 07:00,t/p,2040,5.08,1.39171,1.41836,1.39171,13113.51,272724.05
2008.10.06 15:00,t/p,2042,6.00,1.34932,1.37229,1.34932,8988.00,281712.05
2008.10.24 01:00,s/l,2043,6.70,1.28799,1.28799,1.30901,-5640.06,276071.99
2008.11.05 06:00,s/l,2044,3.47,1.27950,1.27950,1.32403,-5517.30,270554.69
2008.11.13 01:00,close,2046,3.35,1.24600,1.26935,1.22412,2392.91,272947.60
2008.11.13 20:00,s/l,2045,4.25,1.26888,1.26888,1.23694,-6186.30,266761.30
2008.11.14 14:00,s/l,2047,4.60,1.26478,1.26478,1.29509,-2220.88,264540.42
2008.11.19 16:00,s/l,2048,5.54,1.26816,1.26816,1.29200,-5285.16,259255.26
2008.11.20 18:00,s/l,2049,5.17,1.25882,1.25882,1.23376,-5209.81,254045.45
2008.11.26 13:00,s/l,2050,4.86,1.29185,1.29185,1.31797,-5082.59,248962.86
2008.12.01 14:00,t/p,2051,5.48,1.26085,1.28444,1.26085,9771.39,258734.25
2008.12.15 04:00,close,2052,4.63,1.34700,1.32212,1.35566,17586.59,276320.84
2008.12.15 16:00,t/p,2053,6.38,1.36213,1.34025,1.36213,9525.34,285846.18
2008.12.16 14:00,close,2054,5.32,1.37370,1.35953,1.38996,2234.40,288080.58
2008.12.16 21:00,t/p,2055,5.60,1.41291,1.38722,1.41291,8629.60,296710.18
2008.12.16 22:00,s/l,2056,5.44,1.40201,1.40201,1.42924,-5924.16,290786.02
2008.12.17 16:00,t/p,2057,4.70,1.43276,1.39891,1.43276,15299.44,306085.46
2008.12.22 11:00,close,2058,4.18,1.39850,1.41323,1.37227,33.86,306119.32
2008.12.29 11:00,t/p,2059,5.27,1.43322,1.40419,1.43322,9180.34,315299.66
2008.12.31 16:00,s/l,2060,5.37,1.39960,1.39960,1.36936,-2201.70,313097.96
2009.01.06 06:00,t/p,2061,6.16,1.35215,1.37756,1.35215,9382.30,322480.26
2009.01.12 09:00,t/p,2062,5.66,1.33359,1.36228,1.33359,10352.71,332832.96
2009.01.13 06:00,close,2063,4.95,1.32600,1.35444,1.31680,7415.60,340248.56
2009.01.15 20:00,s/l,2064,6.42,1.31699,1.31699,1.29052,-6798.78,333449.78
2009.01.22 19:00,close,2065,5.16,1.29840,1.31500,1.27888,1869.98,335319.76
2009.01.23 19:00,s/l,2066,5.15,1.29782,1.29782,1.26136,-6705.30,328614.46
2009.01.28 09:00,close,2067,5.39,1.32890,1.30931,1.34344,3984.29,332598.75
2009.02.03 16:00,s/l,2068,5.84,1.29908,1.29908,1.26722,-6668.11,325930.64
2009.02.04 12:00,s/l,2069,7.23,1.29204,1.29204,1.31495,-3664.16,322266.47
2009.02.09 15:00,t/p,2070,8.10,1.30373,1.28385,1.30373,9663.30,331929.77
2009.02.18 16:00,t/p,2071,8.51,1.25361,1.27310,1.25361,9932.02,341861.79
2009.02.18 16:00,close,2072,6.50,1.25330,1.27171,1.24284,5252.65,347114.44
2009.02.20 05:00,s/l,2073,6.98,1.25916,1.25916,1.28700,-6943.70,340170.74
2009.02.23 11:00,s/l,2074,8.69,1.28387,1.28387,1.30344,-6804.27,333366.47
2009.03.06 21:00,s/l,2075,8.91,1.26222,1.26222,1.28091,-6664.68,326701.79
2009.03.16 20:00,s/l,2076,9.20,1.29727,1.29727,1.31560,-1039.60,325662.19
2009.03.19 12:00,t/p,2077,7.92,1.36208,1.34095,1.36208,15488.35,341150.54
2009.03.20 11:00,s/l,2078,6.58,1.36014,1.36014,1.38915,-6822.14,334328.40
2009.03.30 08:00,t/p,2079,6.84,1.31751,1.34266,1.31751,15370.16,349698.56
2009.03.30 21:00,close,2080,5.92,1.31990,1.33089,1.29843,7507.15,357205.71
2009.04.06 02:00,t/p,2081,8.52,1.35728,1.33632,1.35728,10704.53,367910.24
2009.04.06 03:00,close,2082,6.32,1.35590,1.33331,1.36492,7131.49,375041.73
2009.04.06 12:00,s/l,2083,9.74,1.34957,1.34957,1.36890,-6360.22,368681.51
2009.04.13 12:00,s/l,2084,9.43,1.32236,1.32236,1.30272,-7164.91,361516.60
2009.04.14 13:00,s/l,2085,7.74,1.32379,1.32379,1.34901,-2490.73,359025.86
2009.04.23 19:00,t/p,2086,11.75,1.31096,1.29569,1.31096,10734.80,369760.66
2009.04.30 14:00,s/l,2087,8.88,1.32097,1.32097,1.34485,-3688.75,366071.91
2009.05.04 09:00,s/l,2088,11.06,1.32758,1.32758,1.34412,-7321.72,358750.19
2009.05.07 18:00,s/l,2089,9.65,1.33567,1.33567,1.35425,-7169.95,351580.24
2009.05.08 19:00,t/p,2090,9.83,1.36003,1.34215,1.36003,10547.59,362127.83
2009.05.12 08:00,close,2091,8.31,1.36500,1.35219,1.37658,3400.45,365528.28
2009.05.21 17:00,t/p,2092,10.93,1.38846,1.37170,1.38846,10313.55,375841.83
2009.05.22 13:00,t/p,2093,11.27,1.39933,1.38245,1.39933,11069.39,386911.23
2009.06.08 09:00,t/p,2094,10.45,1.38768,1.40655,1.38768,15467.05,402378.27
2009.06.09 08:00,s/l,2095,8.54,1.39632,1.39632,1.36994,-8060.91,394317.36
2009.06.10 16:00,s/l,2096,8.56,1.39809,1.39809,1.42387,-7883.76,386433.60
2009.06.16 09:00,s/l,2097,7.65,1.38849,1.38849,1.36024,-7733.39,378700.22
2009.06.23 17:00,t/p,2098,10.57,1.40805,1.38964,1.40805,16119.25,394819.47
2009.06.24 12:00,s/l,2099,8.07,1.40162,1.40162,1.42900,-7892.46,386927.01
2009.07.03 08:00,close,2100,9.30,1.40120,1.40511,1.38184,-4092.00,382835.01
2009.07.14 22:00,s/l,2101,13.27,1.39757,1.39757,1.38315,-7656.79,375178.22
2009.07.20 06:00,close,2102,10.57,1.41650,1.40375,1.42377,7356.72,382534.94
2009.07.31 16:00,t/p,2103,15.88,1.41992,1.40788,1.41992,11465.36,394000.30
2009.08.03 07:00,s/l,2104,14.59,1.42240,1.42240,1.43590,-7890.27,386110.03
2009.08.07 13:00,s/l,2105,11.51,1.43260,1.43260,1.45137,-7757.74,378352.29
2009.08.10 23:00,close,2107,11.50,1.41380,1.42012,1.40046,7705.00,386057.29
2009.08.12 08:00,t/p,2106,13.68,1.40900,1.42400,1.40900,25093.22,411150.51
2009.08.17 11:00,t/p,2108,17.67,1.40712,1.41875,1.40712,12333.66,423484.17
2009.08.20 14:00,s/l,2109,15.55,1.41996,1.41996,1.43357,-9740.52,413743.65
2009.08.28 19:00,s/l,2110,16.35,1.43074,1.43074,1.44339,-10248.18,403495.47
2009.08.31 15:00,s/l,2111,18.17,1.43318,1.43318,1.42197,-7413.36,396082.11
2009.09.02 17:00,s/l,2112,15.93,1.42821,1.42821,1.41569,-8170.50,387911.61
2009.09.04 13:00,s/l,2113,16.00,1.42325,1.42325,1.43537,-9411.20,378500.41
2009.09.04 16:00,s/l,2114,16.05,1.42522,1.42522,1.41343,-7575.60,370924.81
2009.09.09 13:00,t/p,2115,16.04,1.45409,1.44178,1.45409,24031.13,394955.94
2009.09.09 14:00,close,2116,12.35,1.45720,1.44342,1.46100,9252.62,404208.56
2009.09.10 11:00,s/l,2117,16.02,1.45306,1.45306,1.46590,-3306.53,400902.03
2009.09.23 22:00,s/l,2118,14.42,1.47254,1.47254,1.48810,-8750.06,392151.98
2009.10.06 02:00,t/p,2119,15.36,1.46834,1.45527,1.46834,10942.46,403094.44
2009.10.07 14:00,s/l,2120,13.80,1.46676,1.46676,1.48311,-8070.24,395024.20
2009.10.13 15:00,s/l,2121,16.55,1.48123,1.48123,1.49316,-7894.35,387129.85
2009.10.22 09:00,s/l,2122,15.98,1.49536,1.49536,1.50747,-7772.67,379357.18
2009.10.27 07:00,s/l,2123,16.90,1.49086,1.49086,1.47870,5274.49,384631.67
2009.10.29 13:00,s/l,2124,15.01,1.47722,1.47722,1.46441,-7770.68,376860.99
2009.11.02 16:00,s/l,2125,13.69,1.48090,1.48090,1.46714,-7555.51,369305.48
2009.11.03 16:00,s/l,2126,12.92,1.46937,1.46937,1.45495,-6550.44,362755.04
2009.11.13 10:00,close,2127,10.14,1.48850,1.49215,1.47213,-3568.27,359186.78
2009.11.18 09:00,s/l,2128,10.02,1.49167,1.49167,1.47160,-7203.38,351983.40
2009.11.20 13:00,close,2129,10.14,1.48300,1.49474,1.47531,4847.93,356831.33
2009.11.27 08:00,t/p,2130,10.32,1.48866,1.50801,1.48866,12818.47,369649.80
2009.12.07 09:00,t/p,2131,13.87,1.47989,1.49390,1.47989,19960.32,389610.12
2009.12.14 05:00,s/l,2132,14.44,1.46552,1.46552,1.45147,-200.72,389409.41
2009.12.17 03:00,t/p,2133,14.55,1.44662,1.46026,1.44662,14555.82,403965.23
2009.12.18 16:00,t/p,2134,14.32,1.43015,1.44473,1.43015,18660.39,422625.62
2009.12.29 09:00,t/p,2135,16.24,1.44314,1.42990,1.44314,15577.41,438203.03
2010.01.08 15:00,s/l,2136,17.81,1.43558,1.43558,1.44788,-8762.52,429440.51
2010.01.08 16:00,s/l,2137,17.45,1.43088,1.43088,1.44318,-8585.40,420855.11
2010.01.12 03:00,s/l,2138,16.84,1.44741,1.44741,1.46014,-6395.83,414459.27
2010.01.19 11:00,close,2139,13.42,1.43150,1.44438,1.42708,8940.40,423399.68
2010.01.20 03:00,t/p,2140,17.48,1.41966,1.43223,1.41966,20313.51,443713.19
2010.01.22 18:00,s/l,2141,13.23,1.41730,1.41730,1.39853,-8964.65,434748.54
2010.01.27 20:00,t/p,2142,18.49,1.40098,1.41285,1.40098,14978.75,449727.29
2010.02.04 17:00,t/p,2143,15.72,1.37389,1.38993,1.37389,16521.72,466249.01
2010.02.05 15:00,close,2144,15.99,1.36730,1.37743,1.36111,6875.70,473124.71
2010.02.18 22:00,t/p,2145,14.81,1.35252,1.36849,1.35252,14103.56,487228.27
2010.02.19 00:00,t/p,2146,13.58,1.34646,1.36612,1.34646,17139.32,504367.59
2010.02.19 13:00,s/l,2147,17.36,1.35241,1.35241,1.33789,-10086.16,494281.43
2010.02.23 08:00,close,2148,13.26,1.36760,1.35635,1.37721,5028.19,499309.62
2010.02.23 11:00,s/l,2149,17.36,1.36290,1.36290,1.37740,-8506.40,490803.22
2010.03.04 06:00,s/l,2150,16.28,1.36697,1.36697,1.38204,-9855.91,480947.31
2010.03.08 17:00,s/l,2151,16.68,1.36203,1.36203,1.37645,-10124.76,470822.55
2010.03.12 10:00,t/p,2152,17.28,1.37414,1.36041,1.37414,13146.62,483969.17
2010.03.15 04:00,s/l,2153,18.72,1.37253,1.37253,1.38545,-9693.22,474275.96
2010.03.15 11:00,s/l,2154,14.72,1.37045,1.37045,1.38879,-9653.38,464622.58
2010.03.23 12:00,close,2155,14.64,1.34820,1.35894,1.34118,6385.97,471008.55
2010.03.30 07:00,close,2156,16.25,1.35210,1.34051,1.35729,14287.00,485295.55
2010.04.01 16:00,close,2157,15.67,1.35660,1.34461,1.36194,9088.60,494384.15
2010.04.06 04:00,close,2158,16.00,1.34290,1.35808,1.34078,14369.60,508753.75
2010.04.12 08:00,s/l,2159,20.04,1.36070,1.36070,1.37344,-7815.60,500938.15
2010.04.13 10:00,s/l,2160,15.48,1.35687,1.35687,1.37516,-10120.82,490817.32
2010.04.16 13:00,close,2161,15.86,1.35110,1.36169,1.34436,6948.27,497765.59
2010.04.22 15:00,s/l,2162,22.04,1.33321,1.33321,1.32143,1520.76,499286.35
2010.04.23 09:00,s/l,2163,17.90,1.32908,1.32908,1.31346,-9988.20,489298.15
2010.04.30 16:00,s/l,2164,18.57,1.32713,1.32713,1.34056,-4586.79,484711.36
2010.05.10 09:00,t/p,2165,12.35,1.30656,1.28663,1.30656,17981.60,502692.96
2010.05.11 21:00,close,2166,10.80,1.26620,1.28400,1.25795,9180.00,511872.96
2010.05.20 19:00,t/p,2167,9.96,1.25749,1.22873,1.25749,18392.14,530265.10
2010.05.20 22:00,s/l,2168,11.51,1.24729,1.24729,1.27032,-10600.71,519664.39
2010.05.25 21:00,s/l,2169,9.38,1.23490,1.23490,1.20242,-205.42,519458.96
2010.06.01 14:00,s/l,2170,12.13,1.22130,1.22130,1.19981,-8612.30,510846.66
2010.06.07 01:00,t/p,2171,14.26,1.19416,1.21206,1.19416,15288.15,526134.81
2010.06.09 15:00,s/l,2172,10.14,1.20478,1.20478,1.17572,-10563.85,515570.96
2010.06.14 15:00,t/p,2173,16.79,1.22691,1.21156,1.22691,15463.59,531034.55
2010.06.17 08:00,s/l,2174,13.61,1.22530,1.22530,1.24714,-10648.46,520386.08
2010.06.23 01:00,close,2175,14.52,1.22490,1.23737,1.21730,7668.01,528054.10
2010.06.30 10:00,s/l,2176,15.29,1.22671,1.22671,1.20737,-10594.44,517459.65
2010.06.30 14:00,s/l,2177,20.01,1.22373,1.22373,1.23666,-10345.17,507114.48
2010.07.06 05:00,s/l,2179,18.48,1.25456,1.25456,1.24066,-10274.88,496839.60
2010.07.06 07:00,close,2178,13.87,1.25700,1.24233,1.26185,17997.71,514837.32
2010.07.12 20:00,close,2180,15.32,1.25920,1.26462,1.24580,-1991.60,512845.72
2010.07.15 13:00,t/p,2181,18.25,1.28416,1.26990,1.28416,31076.10,543921.82
2010.07.20 03:00,close,2182,15.60,1.29600,1.28533,1.30485,5734.56,549656.38
2010.07.20 16:00,s/l,2183,20.07,1.29158,1.29158,1.27789,-10998.36,538658.02
2010.07.22 11:00,s/l,2184,19.32,1.28538,1.28538,1.27144,-10890.68,527767.33
2010.07.23 17:00,s/l,2185,16.74,1.28800,1.28800,1.27224,-10546.20,517221.13
2010.07.30 09:00,s/l,2186,19.25,1.30260,1.30260,1.31611,-7907.90,509313.23
2010.07.30 13:00,s/l,2187,18.71,1.30568,1.30568,1.29199,-13059.58,496253.65
2010.08.05 10:00,s/l,2188,19.88,1.32069,1.32069,1.30821,-13015.44,483238.22
2010.08.09 12:00,s/l,2189,21.51,1.32471,1.32471,1.33644,-5803.40,477434.82
2010.08.13 02:00,close,2190,14.33,1.28420,1.29416,1.27551,4701.67,482136.49
2010.08.23 21:00,close,2192,13.59,1.26570,1.27792,1.25799,6905.08,489041.57
2010.08.24 13:00,t/p,2191,16.44,1.26027,1.27515,1.26027,19057.25,508098.82
2010.08.30 08:00,s/l,2193,22.28,1.27194,1.27194,1.28334,-10177.50,497921.31
2010.08.31 14:00,s/l,2194,15.43,1.27205,1.27205,1.25398,-9952.35,487968.96
2010.09.03 10:00,close,2196,16.00,1.28410,1.27495,1.29217,4748.80,492717.76
2010.09.03 13:00,t/p,2195,20.71,1.28597,1.27419,1.28597,14575.70,507293.46
2010.09.07 00:00,s/l,2197,18.69,1.28427,1.28427,1.29947,-10163.62,497129.84
2010.09.07 11:00,t/p,2198,24.83,1.27493,1.28504,1.27493,17058.21,514188.05
2010.09.08 08:00,close,2199,18.64,1.26880,1.27484,1.25933,745.60,514933.65
2010.09.15 04:00,s/l,2200,20.94,1.29609,1.29609,1.30887,-3597.49,511336.16
2010.09.16 13:00,s/l,2201,21.02,1.30493,1.30493,1.31735,-7293.94,504042.22
2010.09.22 14:00,t/p,2202,17.24,1.34122,1.32408,1.34122,27604.69,531646.91
2010.09.23 09:00,s/l,2203,16.40,1.33482,1.33482,1.35297,-10666.56,520980.35
2010.09.24 22:00,t/p,2204,18.38,1.34992,1.33572,1.34992,13454.16,534434.51
2010.09.30 10:00,t/p,2205,18.53,1.36672,1.35218,1.36672,15728.26,550162.77
2010.10.04 09:00,s/l,2206,19.06,1.36813,1.36813,1.38256,-11012.87,539149.90
2010.10.06 08:00,t/p,2207,18.95,1.38623,1.37201,1.38623,16149.19,555299.09
2010.10.07 07:00,t/p,2208,15.69,1.39621,1.37659,1.39621,19747.43,575046.53
2010.10.07 13:00,t/p,2209,19.98,1.40114,1.38674,1.40114,17414.57,592461.09
2010.10.07 17:00,s/l,2210,16.10,1.38916,1.38916,1.40943,-11656.40,580804.69
2010.10.12 14:00,close,2211,16.05,1.38140,1.38893,1.36868,481.50,581286.19
2010.10.15 00:00,s/l,2212,20.65,1.40230,1.40230,1.41681,-2701.02,578585.17
2010.10.18 14:00,s/l,2213,19.26,1.39421,1.39421,1.37919,-11575.26,567009.91
2010.10.21 02:00,s/l,2214,14.10,1.38786,1.38786,1.41037,-11370.24,555639.67
2010.10.25 17:00,s/l,2215,15.93,1.39622,1.39622,1.41367,-11278.44,544361.23
2010.11.03 11:00,close,2216,13.14,1.40510,1.39492,1.41810,2486.09,546847.32
2010.11.04 10:00,t/p,2217,17.76,1.42303,1.40764,1.42303,22743.46,569590.78
2010.11.04 19:00,close,2218,12.97,1.42070,1.41382,1.43840,-2464.30,567126.48
2010.11.08 02:00,t/p,2219,18.28,1.39779,1.41397,1.39779,22285.15,589411.63
2010.11.17 17:00,s/l,2220,16.51,1.35558,1.35558,1.33739,-6767.45,582644.18
2010.11.24 10:00,t/p,2221,17.50,1.33322,1.34986,1.33322,17431.75,600075.93
2010.11.25 01:00,close,2222,14.12,1.33220,1.34618,1.32272,7799.89,607875.82
2010.11.29 12:00,close,2223,15.01,1.31680,1.33310,1.31043,10928.78,618804.60
2010.11.30 02:00,s/l,2224,18.77,1.31469,1.31469,1.29821,-12405.09,606399.50
2010.12.06 11:00,s/l,2225,16.45,1.32783,1.32783,1.34626,-12136.81,594262.69
2010.12.15 07:00,s/l,2226,15.45,1.33101,1.33101,1.35254,-11893.41,582369.28
2010.12.28 15:00,s/l,2227,26.37,1.31858,1.31858,1.32962,-12710.34,569658.94
2010.12.30 15:00,t/p,2228,25.13,1.32984,1.31810,1.32984,28688.41,598347.35
2011.01.06 13:00,close,2229,18.99,1.30930,1.32330,1.30566,14514.06,612861.41
2011.01.07 15:00,close,2230,20.25,1.29600,1.30675,1.28981,9517.50,622378.91
2011.01.13 14:00,t/p,2231,19.42,1.32703,1.30909,1.32703,22391.26,644770.17
2011.01.14 09:00,t/p,2232,20.98,1.34280,1.32730,1.34280,22012.22,666782.38
2011.01.17 08:00,s/l,2233,18.25,1.32955,1.32955,1.35013,-9427.95,657354.43
2011.01.19 13:00,t/p,2234,20.97,1.35040,1.33473,1.35040,19695.02,677049.46
2011.01.31 12:00,s/l,2235,25.09,1.36668,1.36668,1.35298,-11287.99,665761.47
2011.02.02 18:00,s/l,2236,18.39,1.37696,1.37696,1.39723,-13314.36,652447.11
2011.02.04 14:00,close,2238,18.40,1.35840,1.37054,1.35054,12661.04,665108.15
2011.02.07 03:00,s/l,2237,24.16,1.36062,1.36062,1.34707,13631.07,678739.22
2011.02.11 15:00,t/p,2239,20.10,1.35114,1.37005,1.35114,24403.41,703142.63
2011.02.22 11:00,s/l,2240,30.59,1.36350,1.36350,1.35174,-9177.00,693965.63
2011.03.07 10:00,t/p,2241,27.82,1.40138,1.38891,1.40138,12975.25,706940.88
2011.03.14 17:00,t/p,2242,32.75,1.39857,1.38778,1.39857,21189.25,728130.13
2011.03.29 06:00,s/l,2243,26.53,1.41199,1.41199,1.39827,-14665.78,713464.34
2011.04.01 10:00,s/l,2244,22.08,1.41424,1.41424,1.43233,-14281.34,699183.00
2011.04.01 15:00,s/l,2245,31.26,1.41077,1.41077,1.39959,-13973.22,685209.78
2011.04.07 11:00,s/l,2246,22.92,1.42722,1.42722,1.44425,-5051.57,680158.21
2011.04.08 20:00,t/p,2247,33.57,1.44578,1.43532,1.44578,31488.66,711646.87
2011.04.11 14:00,close,2248,24.74,1.44510,1.43997,1.45517,7154.81,718801.68
2011.04.19 12:00,s/l,2249,23.43,1.42937,1.42937,1.41293,-12860.73,705940.95
2011.04.21 06:00,t/p,2250,21.01,1.46150,1.44268,1.46150,21799.98,727740.93
2011.04.27 18:00,close,2251,21.90,1.47250,1.46196,1.48056,8541.00,736281.93
2011.05.02 15:00,t/p,2252,24.06,1.48799,1.47268,1.48799,20330.70,756612.63
2011.05.06 13:00,t/p,2253,28.96,1.44963,1.46375,1.44963,59515.70,816128.32
2011.05.06 17:00,t/p,2254,21.09,1.43841,1.45986,1.43841,29083.11,845211.43
2011.05.06 22:00,t/p,2255,25.84,1.43009,1.44644,1.43009,25349.04,870560.47
2011.05.09 14:00,t/p,2256,27.65,1.43036,1.44610,1.43036,26101.60,896662.07
2011.05.12 18:00,s/l,2257,23.36,1.42769,1.42769,1.40588,-15760.99,880901.08
2011.06.01 00:00,close,2259,23.09,1.44240,1.43083,1.45259,8755.73,889656.81
2011.06.01 20:00,s/l,2258,33.36,1.43472,1.43472,1.44843,4376.83,894033.64
2011.06.02 08:00,s/l,2260,31.08,1.43845,1.43845,1.42407,-18048.16,875985.49
2011.06.03 09:00,close,2261,22.99,1.44900,1.44088,1.46222,1131.11,877116.60
2011.06.06 19:00,s/l,2262,33.40,1.45749,1.45749,1.47126,2945.88,880062.48
2011.06.07 08:00,close,2263,25.92,1.46570,1.45520,1.47453,9310.46,889372.94
2011.06.10 14:00,t/p,2264,31.51,1.44163,1.45574,1.44163,26629.10,916002.04
2011.06.16 21:00,s/l,2265,25.00,1.42147,1.42147,1.40028,-4925.00,911077.04
2011.06.23 22:00,s/l,2266,22.85,1.42657,1.42657,1.40425,-18211.45,892865.59
2011.07.12 08:00,t/p,2267,23.95,1.38898,1.40985,1.38898,32095.40,924960.99
2011.07.27 15:00,s/l,2268,29.85,1.44167,1.44167,1.45725,-15933.93,909027.06
2011.07.28 11:00,t/p,2269,30.75,1.42833,1.44311,1.42833,27099.97,936127.03
2011.07.29 02:00,close,2270,22.09,1.43060,1.44495,1.42184,11886.63,948013.66
2011.08.04 09:00,s/l,2271,26.71,1.42530,1.42530,1.44304,-19028.20,928985.46
2011.08.18 01:00,s/l,2272,22.26,1.44066,1.44066,1.46152,-18618.26,910367.19
2011.08.22 07:00,s/l,2273,23.53,1.43488,1.43488,1.45442,-10889.68,899477.51
2011.08.30 20:00,s/l,2274,32.68,1.44656,1.44656,1.43240,-10980.48,888497.03
2011.09.06 09:00,s/l,2275,26.46,1.41781,1.41781,1.39902,-17804.93,870692.09
2011.09.08 18:00,t/p,2276,30.42,1.38971,1.40402,1.38971,26130.78,896822.87
2011.09.12 13:00,s/l,2277,22.54,1.36756,1.36756,1.34528,-17941.84,878881.03
2011.09.22 18:00,close,2278,18.42,1.34530,1.35604,1.32933,2210.40,881091.43
2011.10.13 10:00,s/l,2279,22.53,1.37188,1.37188,1.39143,-17672.53,863418.90
2011.10.14 07:00,s/l,2280,22.25,1.38026,1.38026,1.36086,-17308.28,846110.63
2011.10.19 19:00,s/l,2281,18.18,1.37560,1.37560,1.40165,-16907.40,829203.23
2011.10.26 19:00,s/l,2282,26.02,1.39007,1.39007,1.37414,-20998.14,808205.09
2011.10.31 02:00,s/l,2283,18.62,1.40982,1.40982,1.43412,-16191.95,792013.13
2011.10.31 20:00,t/p,2284,23.32,1.38936,1.40659,1.38936,27844.08,819857.21
2011.10.31 20:00,t/p,2285,18.41,1.38415,1.40834,1.38415,28627.55,848484.76
2011.11.01 09:00,t/p,2286,18.51,1.36930,1.39497,1.36930,30506.33,878991.10
2011.11.02 09:00,s/l,2287,18.24,1.37704,1.37704,1.35005,-17618.02,861373.08
2011.11.10 07:00,t/p,2288,21.22,1.35083,1.37144,1.35083,35677.19,897050.27
2011.11.11 15:00,s/l,2289,18.05,1.36913,1.36913,1.34189,-17699.83,879350.44
2011.11.14 09:00,s/l,2290,22.68,1.36998,1.36998,1.38977,-8455.10,870895.33
2011.11.17 00:00,t/p,2291,17.32,1.34308,1.37064,1.34308,34683.30,905578.63
2011.11.25 04:00,close,2292,21.99,1.33110,1.34256,1.31943,11267.68,916846.31
2011.11.30 20:00,s/l,2293,30.29,1.34210,1.34210,1.35736,-29078.40,887767.91
2011.12.05 09:00,s/l,2294,29.26,1.34517,1.34517,1.33000,-19864.61,867903.29
2011.12.09 11:00,s/l,2295,29.96,1.33819,1.33819,1.32347,-15905.76,851997.53
2011.12.14 13:00,t/p,2296,27.95,1.29879,1.31430,1.29879,27365.85,879363.37
2011.12.21 11:00,t/p,2297,34.29,1.31616,1.30322,1.31616,28981.91,908345.28
2011.12.29 12:00,t/p,2298,50.24,1.28676,1.29633,1.28676,58192.99,966538.27
2011.12.29 14:00,close,2299,30.40,1.28930,1.29800,1.28203,15634.72,982172.99
2012.01.04 12:00,s/l,2300,40.58,1.30013,1.30013,1.31377,-9244.12,972928.87
2012.01.05 09:00,t/p,2301,53.22,1.28746,1.29702,1.28746,52597.33,1025526.20
2012.01.06 14:00,close,2302,38.40,1.27350,1.28325,1.26884,22199.04,1047725.24
2012.01.09 09:00,s/l,2303,48.46,1.27575,1.27575,1.26463,-11964.77,1035760.46
2012.01.17 03:00,s/l,2304,39.71,1.27180,1.27180,1.25829,-16829.10,1018931.36
2012.01.17 05:00,s/l,2305,34.28,1.27372,1.27372,1.25686,-19395.62,999535.74
2012.01.18 10:00,t/p,2306,38.73,1.28098,1.26801,1.28098,30488.26,1030024.00
2012.01.27 01:00,s/l,2307,32.07,1.30858,1.30858,1.32656,-20614.60,1009409.40
2012.02.10 13:00,s/l,2308,35.54,1.31873,1.31873,1.33315,-19582.54,989826.86
2012.02.10 13:00,s/l,2309,30.61,1.31917,1.31917,1.33773,-20392.38,969434.48
2012.02.13 00:00,s/l,2310,37.05,1.32253,1.32253,1.30945,-19447.55,949986.93
2012.02.13 01:00,s/l,2311,28.77,1.32462,1.32462,1.30581,-19388.10,930598.83
2012.02.14 14:00,close,2312,29.58,1.31570,1.32306,1.30526,1183.20,931782.03
2012.02.21 04:00,t/p,2313,38.43,1.32877,1.31665,1.32877,27907.87,959689.90
2012.02.23 15:00,s/l,2314,40.18,1.32802,1.32802,1.33996,-19206.04,940483.86
2012.02.27 13:00,s/l,2315,32.54,1.33947,1.33947,1.35551,527.15,941011.00
2012.03.01 14:00,t/p,2316,41.12,1.32884,1.34028,1.32884,27973.94,968984.94
2012.03.02 08:00,close,2317,32.58,1.32680,1.34040,1.32417,25350.50,994335.44
2012.03.06 10:00,close,2318,34.82,1.31860,1.32471,1.30872,1326.64,995662.08
2012.03.08 04:00,s/l,2319,34.85,1.31721,1.31721,1.30095,-9709.21,985952.87
2012.03.09 13:00,s/l,2320,36.53,1.32030,1.32030,1.33541,-19755.42,966197.45
2012.03.19 16:00,t/p,2321,42.75,1.32449,1.31301,1.32449,34550.55,1000748.00
2012.03.20 10:00,s/l,2322,34.52,1.31910,1.31910,1.33533,-20049.22,980698.78
2012.03.28 15:00,s/l,2323,34.85,1.32937,1.32937,1.34513,-19648.43,961050.35
2012.04.02 17:00,s/l,2324,47.29,1.33316,1.33316,1.32300,-19199.74,941850.61
2012.04.04 09:00,t/p,2325,43.24,1.31676,1.32766,1.31676,20846.00,962696.61
2012.04.05 10:00,close,2326,34.54,1.30680,1.31717,1.30157,16382.32,979078.94
2012.04.06 13:00,close,2327,44.38,1.30990,1.31141,1.30038,-14729.72,964349.21
2012.04.09 01:00,s/l,2328,44.52,1.30427,1.30427,1.31510,-25100.38,939248.84
2012.04.16 01:00,t/p,2329,43.68,1.30175,1.31250,1.30175,28090.61,967339.45
